一|one
二|two
三|three
四|four
五|five
六|six
七|seven
八|eight
九|nine
十|ten
百|hundred
千|thousand
上|above, up
下|below, down, descend, give, low, inferior
左|left
右|right
中|in, inside, middle, mean, center
大|large, big
小|little, small
月|month, moon
日|day, sun, Japan
年|year
早|early, fast
木|tree, wood
林|grove, forest
山|mountain
川|stream, river
土|soil, earth, ground, Turkey
空|empty, sky, void, vacant, vacuum
田|rice field, rice paddy
天|heavens, sky, imperial
生|life, genuine, birth
花|flower
草|grass, weeds, herbs, pasture, write, draft
虫|insect, bug, temper
犬|dog
人|person
名|name, noted, distinguished, reputation
女|woman, female
男|male
子|child
目|eye, class, look, insight, experience, care, favor
耳|ear
口|mouth
手|hand
足|leg, foot, be sufficient
見|see, hopes, chances, idea, opinion, look at, visible
音|sound, noise
力|power, strong, strain, bear up, exert
気|spirit, mind
円|circle, yen, round
入|enter, insert
出|exit, leave
立|stand up
休|rest, day off, retire, sleep
先|before, ahead, previous, future, precedence
夕|evening
本|book, present, main, true, real, no. of long things
文|sentence, literature, style, art, decoration, figures, plan
字|character, letter, word, section of village
学|study, learning, science
校|exam, school, printing, proof, correction
村|town, village
町|village, town, block, street
森|forest, woods
正|correct, justice, righteous, 10**40
水|water
火|fire
玉|jewel, ball
王|king, rule, magnate
石|stone
竹|bamboo
糸|thread
貝|shellfish
車|car
金|gold
雨|rain
赤|red
青|blue, green
白|white
数|number, strength, fate, law, figures
多|many, frequent, much
少|few, little
万|ten thousand
半|half, middle, odd number, semi-, part-
形|shape, form, style
太|plump, fat, thick, big around
細|dainty, get thin, taper, slender, narrow
広|wide, broad, spacious
長|long, leader
点|spot, point, mark, speck, decimal point
丸|round, full, month, perfection, -ship, pills, make round, roll up, curl up, seduce, explain away
交|mingle, mixing, association, coming & going
光|ray, light
角|angle, corner, square
計|plot, plan, scheme, measure
直|straightaway, honesty, frankness, fix, repair
線|line, track
矢|dart, arrow
弱|weak, frail
強|strong
高|tall, high, expensive
同|same, agree, equal
親|parent, intimacy, relative, familiarity, dealer (cards)
母|mama, mother
父|father
姉|elder sister
兄|elder brother, big brother
弟|younger brother, faitherful service to elders
妹|younger sister
自|oneself
友|friend
体|body, substance, object, reality, counter for images
毛|fur, hair, feather, down
頭|head, counter for large animals
顔|face, expression
首|neck
心|heart, mind, spirit
時|time, hour
曜|weekday
朝|morning, dynasty, regime, epoch, period, (North) Korea
昼|daytime, noon
夜|night, evening
分|part, minute of time, segment, share, degree, one's lot, duty, understand, know, rate, 1%, chances, shaku/10
週|week
春|springtime, spring (season)
夏|summer
秋|autumn
冬|winter
今|now
新|new
古|old
間|interval, space
方|direction, person, alternative
北|north
南|south
東|east
西|west, Spain
遠|distant, far
近|near, early, akin, tantamount
前|in front, before
後|behind, back, later
内|inside, within, between, among, house, home
外|outside
場|location, place
地|ground, earth
国|country
園|park, garden, yard, farm
谷|valley
野|plains, field, rustic, civilian life
原|meadow, original, primitive, field, plain, prairie, tundra, wilderness
里|ri, village, parent's home, league
市|market, city, town
京|capital, 10**16
風|wind, air, style, manner
雪|snow
雲|cloud
池|pond, cistern, pool, reservoir
海|sea, ocean
岩|boulder, rock, cliff
星|star, spot, dot, mark
室|room, apartment, chamber, greenhouse, cellar
戸|door
家|house, home
寺|Buddhist temple
通|traffic, pass through, avenue, commute, counter for letters
門|gates
道|road-way, street, district, journey, course, moral, teachings
話|tale, talk
言|say
答|solution, answer
声|voice
聞|hear, ask, listen
語|word, speech, language
読|read
書|write
記|scribe, account, narrative
紙|paper
画|brush-stroke, picture
絵|picture, drawing, painting, sketch
図|map, drawing, plan, unexpected, accidentally
工|craft, construction
教|teach, faith, doctrine
晴|clear up
思|think
考|consider, think over
知|know, wisdom
才|genius, years old
理|logic, arrangement, reason, justice, truth
算|calculate, divining, number, abacus, probability
作|make, production, prepare, build
元|beginning, former time, origin
食|eat, food
肉|meat
馬|horse
牛|cow
魚|fish
鳥|bird, chicken
羽|feathers, counter for birds, rabbits
鳴|chirp, cry, bark, sound, ring, echo, honk
麦|barley, wheat
米|rice, USA
茶|tea
色|color
黄|yellow
黒|black
来|come, due, next, cause, become
行|going, journey
帰|homecoming, arrive at, lead to, result in
歩|walk
走|run
止|stop, halt
活|lively, resuscitation, being helped, living
店|store, shop
買|buy
売|sell
午|noon
汽|vapor, steam
弓|bow, bow (archery, violin)
回|-times, round, game, revolve, counter for occurrences
会|meeting, meet, party, association, interview, join
組|association, braid, plait, construct, assemble, unite, cooperate, grapple
船|ship, boat
明|bright, light
社|company, firm, office, association, shrine
切|cut, cutoff, be sharp
電|electricity
毎|every
合|fit, suit, join, 0.1
当|hit, right, appropriate, himself
台|pedestal, a stand, counter for machines and vehicles
楽|music, comfort, ease
公|public, prince, official, governmental
引|pull, tug, jerk, admit, install, quote, refer to
科|department, course, section
歌|song, sing
刀|sword, saber, knife
番|turn, number in a series
用|utilize, business, service, use, employ
何|what
丁|street, ward, town, counter for guns, tools, leaves or cakes of something, even number, 4th calendar sign
世|generation, world, society, public
両|both, old Japanese coin, no. of vehicles, two
主|lord, chief, master, main thing, principal
乗|ride, power, multiplication, record, no. of vehicles, board, mount, join
予|beforehand, previous, myself, I
事|matter, thing, fact, business, reason, possibly
仕|attend, doing, official, serve
他|other, another, the others
代|substitute, change, convert, replace, period, age, generation, charge, rate, fee
住|dwell, reside, live, inhabit
使|use
係|person in charge, connection, duty, concern oneself
倍|double, twice, times, fold
全|whole, entire, all, complete, fulfill
具|tool, utensil, means, possess, ingredients, counter for armor, suits, sets of furniture
写|copy, be photographed, describe
列|file, row, rank, tier, column
助|help, rescue, assist
勉|exertion
動|move, motion, change, confusion, shift, shake
勝|victory, win, prevail, excel
化|change, take the form of, influence, enchant, delude, -ization
区|ward, district
医|doctor, medicine
去|gone, past, quit, leave, elapse, eliminate, divorce
反|anti-
取|take, fetch, take up
受|accept, undergo, answer (phone), take, get, catch, receive
号|nickname, number, item, title, pseudonym, name, call
向|yonder, facing, beyond, confront, defy, tend toward, approach
君|old boy, name-suffix
味|flavor, taste
命|fate, command, decree, destiny, life, appoint
和|harmony, Japanese style, peace, soften, Japan
品|goods, refinement, dignity, article, counter for meal courses
員|employee, member, number, the one in charge
商|make a deal, selling, dealing in, merchant
問|question, ask, problem
坂|slope, incline, hill
央|center, middle
始|commence, begin
委|committee, entrust to, leave to, devote, discard
守|guard, protect, defend, obey
安|relax, cheap, low, quiet, rested, contented, peaceful
定|determine, fix, establish, decide
実|reality, truth
客|guest, visitor, customer, client
宮|Shinto shrine, constellations, palace, princess
宿|inn, lodging, relay station, dwell, lodge, be pregnant, home, dwelling
寒|cold
対|vis-a-vis, opposite, even, equal, versus, anti-, compare
局|bureau, board, office, affair, conclusion, court lady, lady-in-waiting, her apartment
屋|roof, house, shop, dealer, seller
岸|beach
島|island
州|state, province
帳|notebook, account book, album
平|even, flat, peace
幸|happiness, blessing, fortune
度|degrees, occurrence, time, counter for occurrences
庫|warehouse, storehouse
庭|courtyard, garden, yard
式|style, ceremony, rite, fn, method, system, form, expr
役|duty, war, campaign, drafted labor, office, service, role
待|wait, depend on
急|hurry, emergency, sudden, steep
息|breath, respiration, son, interest (on money)
悪|bad, vice, rascal, false, evil, wrong
悲|jail cell, grieve, sad, deplore, regret
想|concept, think, idea, thought
意|idea, mind, heart, taste, thought, desire, care, liking
感|emotion, feeling, sensation
所|place
打|strike, hit, knock, pound, dozen
投|throw, discard, abandon, launch into, join, invest in, hurl, give up, sell at a loss
拾|pick up, gather, find, go on foot
持|hold, have
指|finger, point to, indicate, put into, play (chess), measure (ruler)
放|set free, release, fire, shoot, emit, banish, liberate
整|organize, arranging, tune, tone, meter, key (music)
旅|trip, travel
族|tribe, family
昔|once upon a time, antiquity, old times
昭|shining, bright
暑|sultry, hot, summer heat
暗|darkness, disappear, shade, informal, grow dark, be blinded
曲|bend, music, melody, composition, pleasure, injustice, fault, curve, crooked, perverse, lean
有|possess, have, exist, happen, occur, approx
服|clothing, admit, obey, discharge
期|period, time, date, term
板|plank, board, plate, stage
柱|pillar, post, cylinder, support
根|root, radical, head (pimple)
植|plant
業|business, vocation, arts, performance
様|Esq., way, manner, situation, polite suffix
横|sideways, side, horizontal, width, woof
橋|bridge
次|next, order, sequence
歯|tooth, cog
死|death, die
氷|icicle, ice, hail, freeze, congeal
決|decide, fix, agree upon, appoint
油|oil, fat
波|waves, billows, Poland
注|pour, irrigate, shed (tears), flow into, concentrate on, notes, comment, annotate
泳|swim
洋|ocean, western style
流|current, a sink, flow, forfeit
消|extinguish, blow out, turn off, neutralize, cancel
深|deep, heighten, intensify, strengthen
温|warm
港|harbor
湖|lake
湯|hot water, bath, hot spring
漢|Sino-, China
炭|charcoal, coal
物|thing, object, matter
球|ball, sphere
由|wherefore, a reason
申|speak, have the honor to, monkey (zodiac sign)
界|world
畑|farm, field, garden, one's specialty, (kokuji)
病|ill, sick
発|discharge, departure, publish, emit, start from, disclose
登|ascend, climb up
皮|pelt, skin, hide, leather
皿|dish, a helping, plate
相|inter-, mutual, together, each other, minister of state, councillor, aspect, phase, physiognomy
県|prefecture
真|true, reality, Buddhist sect
着|don, arrive, wear, counter for suits of clothing
短|short, brevity, fault, defect, weak point
研|polish, study of, sharpen
礼|salute, bow, ceremony, thanks, remuneration
神|gods, mind, soul
祭|ritual, offer prayers, celebrate, deify, enshrine, worship
福|blessing, fortune, luck, wealth
秒|second (1/60 minute)
究|research, study
章|badge, chapter, composition, poem, design
童|juvenile, child
笛|flute, clarinet, pipe, whistle, bagpipe, piccolo
第|No., residence
筆|writing brush, writing, painting brush, handwriting
等|etc., and so forth, class (1st), quality, equal, similar
箱|box, chest, case, bin, railway car
級|class, rank, grade
終|end, finish
緑|green
練|practice, gloss, train, drill, polish, refine
羊|sheep
美|beauty, beautiful
習|learn
者|someone, person
育|bring up, grow up, raise, rear
苦|suffering, trial, worry, hardship, feel bitter, scowl
荷|baggage, shoulder-pole load, bear (a burden), shoulder (a gun), load, cargo, freight
落|fall, drop, come down
葉|leaf, plane, lobe, needle, blade, spear, no. of flat things
薬|medicine, chemical, enamel, gunpowder, benefit
血|blood
表|surface, table, chart, diagram
詩|poem, poetry
調|tune, tone, meter, key (music), writing style, prepare, exorcise, investigate
談|discuss, talk
豆|beans, pea, midget
負|defeat, negative, -, minus, bear, owe, assume a responsibility
起|rouse, wake up, get up
路|path, route, road, distance
身|body, somebody, person, one's station in life
転|revolve, turn around, change
軽|lightly, trifling, unimportant
農|agriculture, farmers
返|return, answer, fade, repay
追|chase, drive away, follow, pursue, meanwhile
送|escort, send
速|quick, fast
進|advance, proceed, progress, promote
遊|play
運|carry, luck, destiny, fate, lot, transport, progress, advance
部|section, bureau, dept, class, copy, part, portion, counter for copies of a newspaper or magazine
都|metropolis, capital
配|distribute, spouse, exile, rationing
酒|sake, alcohol
重|heavy, heap up, pile up, nest of boxes, -fold
鉄|iron
銀|silver
開|open, unfold, unseal
院|Inst., institution, temple, mansion, school
陽|sunshine, yang principle, positive, male, heaven, daytime
階|storey, stair, counter for storeys of a building
集|gather, meet, congregate, swarm, flock
面|mask, face, features, surface
題|topic, subject
飲|drink, smoke, take
館|building, mansion, large building, palace
駅|station
鼻|nose, snout
不|negative, non-, bad, ugly, clumsy
争|contend, dispute, argue
付|adhere, attach, refer to, append
令|orders, ancient laws, command, decree
以|by means of, because, in view of, compared with
仲|go-between, relationship
伝|transmit, go along, walk along, follow, report, communicate, legend, tradition
位|rank, grade, throne, crown, about, some
低|lower, short, humble
例|example, custom, usage, precedent
便|convenience
信|faith, truth, fidelity, trust
倉|godown, warehouse, storehouse, cellar, treasury
候|climate, season, weather
借|borrow, rent
停|halt, stopping
健|healthy, health, strength, persistence
側|side, lean, oppose, regret
働|work
億|hundred million, 10**8
兆|portent, 10**12, trillion, sign, omen, symptoms
児|newborn babe, child, young of animals
共|together, both, neither, all, and, alike, with
兵|soldier, private, troops, army, warfare, strategy, tactics
典|code, ceremony, law, rule
冷|cool, cold (beer, person), chill
初|first time, beginning
別|separate, branch off, diverge, fork, another, extra, specially
利|profit, advantage, benefit
刷|printing, print
副|vice-, duplicate, copy
功|achievement, merits, success, honor, credit
加|add, addition, increase, join, include, Canada
努|toil, diligent, as much as possible
労|labor, thank for, reward for, toil, trouble
勇|courage, cheer up, be in high spirits, bravery, heroism
包|wrap, pack up, cover, conceal
卒|graduate, soldier, private, die
協|co-, cooperation
単|simple, one, single, merely
博|Dr., command, esteem, win acclaim, Ph.D., exposition, fair
印|stamp, seal, mark, imprint, symbol, emblem, trademark, evidence, souvenir, India
参|nonplussed, three, going, coming, visiting, visit, be defeated, die, be madly in love
史|history, chronicle
司|director, official, govt office, rule, administer
各|each, every, either
告|revelation, tell, inform, announce
周|circumference, circuit, lap
唱|chant, recite, call upon, yell
喜|rejoice, take pleasure in
器|utensil, vessel, receptacle, implement, instrument, ability, container, tool, set
囲|surround, besiege, store, paling, enclosure, encircle, preserve, keep
固|harden, set, clot, curdle
型|mould, type, model
堂|public chamber, hall
塩|salt
士|gentleman, samurai
変|unusual, change, strange
夫|husband, man
失|lose, error, fault, disadvantage, loss
好|fond, pleasing, like something
季|seasons
孫|grandchild, descendants
完|perfect, completion, end
官|bureaucrat, the government
害|harm, injury
察|guess, presume, surmise, judge, understand
巣|nest, rookery, hive, cobweb, den
差|distinction, difference, variation, discrepancy, margin, balance
希|hope, beg, request, pray, beseech, Greece, dilute (acid), rare, few, phenomenal
席|seat, mat, occasion, place
帯|sash, belt, obi, zone, region
底|bottom, sole, depth, bottom price, base, kind, sort
府|borough, urban prefecture, govt office, representative body, storehouse
康|ease, peace
建|build
径|diameter, path, method
徒|junior, emptiness, vanity, futility, uselessness, ephemeral thing, gang, set, party, people
得|gain, get, find, earn, acquire, can, may, able to, profit, advantage, benefit
必|invariably, certain, inevitable
念|wish, sense, idea, thought, feeling, desire, attention
愛|love, affection, favourite
成|turn into, become, get, grow, elapse, reach
戦|war, battle, match
折|fold, break, fracture, bend, yield, submit
挙|raise, plan, project, behavior, actions
改|reformation, change, modify, mend, renew, examine, inspect, search
救|salvation, save, help, rescue, reclaim
敗|failure, defeat, reversal
散|scatter, disperse, spend, squander
料|fee, materials
旗|national flag, banner, standard
昨|yesterday, previous
景|scenery, view
最|utmost, most, extreme
望|ambition, full moon, hope, desire, aspire to, expect
未|un-, not yet, hitherto, still, even now
末|not yet, end, close, tip, powder, posterity
札|tag, paper money, no. of bonds, placard, bid
材|lumber, log, timber, wood, talent
束|bundle, sheaf, ream, tie in bundles, govern, manage, control
松|pine tree
果|fruit, reward, carry out, achieve, complete, end, finish, succeed
栄|flourish, prosperity, honor, glory, splendor
案|plan, suggestion, draft, ponder, fear, proposition, idea, expectation, bill, worry
梅|plum
械|contraption, fetter, machine, instrument
極|poles, settlement, conclusion, end, highest rank, electric poles, very, extremely, most, highly, 10**48
標|signpost, seal, mark, stamp, imprint, symbol, emblem, trademark, evidence, souvenir, target
機|mechanism, opportunity, occasion, machine, airplane
欠|lack, gap, fail, yawn
歴|curriculum, continuation, passage of time
残|remainder, leftover, balance
殺|kill, murder, butcher, slice off, split, diminish, reduce, spoil
毒|poison, virus, venom, germ, harm, injury, spite
氏|family name, surname, clan
民|people, nation, subjects
求|request, want, wish for, require, demand
治|reign, be at peace, calm down, subdue, quell, govt, cure, heal, rule, conserve
法|method, law, rule, principle, model, system
泣|cry, weep, moan
浅|shallow, superficial, frivolous, wretched, shameful
浴|bathe, be favored with, bask in
清|pure, purify, cleanse, exorcise, Manchu dynasty
満|full, enough, pride, satisfy
漁|fishing, fishery
灯|lamp, a light, light, no. of lights
無|nothingness, none, ain't, nothing, nil, not
然|sort of thing, so, if so, in that case, well
焼|bake, burning
照|illuminate, shine, compare, bashful
熱|heat, temperature, fever, mania, passion
牧|breed, care for, shepherd, feed, pasture
特|special
産|products, bear, give birth, yield, childbirth, native, property
的|bull's eye, mark, target, object, adjective ending
省|focus, government ministry, conserve
祝|celebrate, congratulate
票|ballot, label, ticket, sign
種|species, kind, class, variety, seed
積|volume, product (x*y), acreage, contents, pile up, stack, load, amass
競|emulate, compete with, bid, sell at auction, bout, contest, race
笑|laugh
管|pipe, tube, wind instrument, drunken talk
節|node, season, period, occasion, verse, clause, stanza, honor, joint, knuckle, knob, knot, tune, melody
粉|flour, powder, dust
紀|chronicle, account, narrative, history, annals, geologic period
約|promise, approximately, shrink
結|tie, bind, contract, join, organize, do up hair, fasten
給|salary, wage, gift, allow, grant, bestow on
続|continue, series, sequel
置|placement, put, set, deposit, leave behind, keep, employ, pawn
老|old man, old age, grow old
胃|stomach, paunch, crop, craw
脈|vein, pulse, hope
腸|intestines, guts, bowels, viscera
臣|retainer, subject
航|navigate, sail, cruise, fly
良|good, pleasing, skilled
芸|technique, art, craft, performance, acting, trick, stunt
芽|bud, sprout, spear, germ
英|England, English
菜|vegetable, side dish, greens
街|boulevard, street, town
衣|garment, clothes, dressing
要|need, main point, essence, pivot, key to
覚|memorize, learn, remember, awake, sober up
観|outlook, look, appearance, condition, view
訓|instruction, Japanese character reading, explanation, read
試|test, try, attempt, experiment, ordeal
説|rumor, opinion, theory
課|chapter, lesson, section, department, division, counter for chapters (of a book)
議|deliberation, consultation, debate, consideration
象|elephant, pattern after, imitate, image, shape, sign (of the times)
貨|freight, goods, property
貯|savings, store, lay in, keep, wear mustache
費|expense, cost, spend, consume, waste
賞|prize, reward, praise
軍|army, force, troops, war, battle
輪|wheel, ring, circle, link, loop, counter for wheels and flowers
辞|resign, word, term, expression
辺|environs, boundary, border, vicinity, (kokuji)
連|take along, lead, join, connect, party, gang, clique
達|accomplished, reach, arrive, attain
選|elect, select, choose, prefer
郡|county, district
量|quantity, measure, weight, amount
録|record
鏡|mirror, speculum, barrel-head, round rice-cake offering
関|connection, barrier, gateway, involve, concerning
陸|land
隊|regiment, party, company, squad
静|quiet
順|obey, order, turn, right, docility, occasion
願|petition, request, vow, wish, hope
類|sort, kind, variety, class, genus
飛|fly, skip (pages, scatter
飯|meal, boiled rice
養|foster, bring up, rear, develop, nurture
験|verification, effect, testing
久|long time, old story
仏|Buddha, the dead, France
仮|sham, temporary, interim, assumed (name), informal
件|affair, case, matter, item
任|responsibility, duty, term, entrust to, appoint
似|becoming, resemble, counterfeit, imitate, suitable
余|too much, myself, surplus, other, remainder
価|value, price
保|protect, guarantee, keep, preserve, sustain, support
修|discipline, conduct oneself well, study, master
俵|bag, bale, sack, counter for bags
個|individual, counter for articles and ilitary units
備|equip, provision, preparation
像|statue, picture, image, figure, portrait
再|again, twice, second time
刊|publish, carve, engrave
判|judgement, signature, stamp, seal
制|system, law, rule
券|ticket
則|rule, follow, based on, model after
効|merit, efficacy, efficiency, benefit
務|task, duties
勢|forces, energy, military strength
厚|thick, heavy, rich, kind, cordial, brazen, shameless
句|phrase, clause, sentence, passage, paragraph, counter for haiku
可|can, passable, mustn't, should not, do not
営|occupation, camp, perform, build, conduct (business)
因|cause, factor, be associated with, depend on, be limited to
団|group, association
圧|pressure, push, overwhelm, oppress, dominate
在|exist, outskirts, suburbs, located in
均|level, average
基|fundamentals, radical (chem), counter for machines, foundation
報|report, news, reward, retribution
境|boundary, border, region
墓|grave, tomb
増|increase, add, augment, gain, promote
夢|dream, vision, illusion
妻|wife, spouse
婦|lady, woman, wife, bride
容|contain, form, looks
寄|draw near, stop in, bring near, gather, collect, send, forward
富|wealth, enrich, abundant
導|guidance, leading, conduct, usher
居|reside, to be, exist, live with
属|belong, genus, subordinate official, affiliated
布|linen, cloth
師|expert, teacher, master, army, war
常|usual, ordinary, normal, regular
幹|tree-trunk
序|preface, beginning, order, precedence, occasion, chance, incidentally
弁|valve, petal, braid, speech, dialect, discrimination, dispose of, distinguish
張|lengthen, counter for bows & stringed instruments, stretch, spread, put up (tent)
往|journey, chase away, let go, going, travel
復|restore, return to, revert, resume
徳|benevolence, virtue, goodness, commanding respect
志|intention, plan, resolve, aspire, motive, hopes, shilling
応|apply, answer, yes, OK, reply, accept
快|cheerful, pleasant, agreeable, comfortable
性|sex, gender, nature
恩|grace, kindness, goodness, favor, mercy, blessing, benefit
情|feelings, emotion, passion, sympathy, circumstances, facts
態|attitude, condition, figure, appearance, voice (of verbs)
慣|accustomed, get used to, become experienced
承|aquiesce, hear, listen to, be informed, receive
技|skill, art, craft, ability, feat, performance, vocation, arts
招|beckon, invite, summon, engage
授|impart, instruct, grant, confer
採|pick, take, fetch, take up
接|touch, contact, adjoin, piece together
提|propose, take along, carry in hand
損|damage, loss, disadvantage, hurt, injure
支|branch, support, sustain
政|politics, government
故|happenstance, especially, intentionally, reason, cause, circumstances, the late, therefore, consequently
敵|enemy, foe, opponent
断|severance, decline, refuse, apologize, warn, dismiss, prohibit, decision, judgement, cutting
旧|old times, old things, old friend, former, ex-
易|easy, fortune-telling, ready to, simple, divination
暴|outburst, rave, fret, force, violence, cruelty, outrage
条|article, clause, item, stripe, streak
枝|bough, branch, twig, limb
査|investigate
格|status, rank, capacity, character, case (law, grammar)
桜|cherry tree
検|examination, investigate
構|posture, build, pretend
武|warrior, military, chivalry, arms
比|compare, race, ratio, Phillipines
永|eternity, long, lengthy
河|river
液|fluid, liquid, juice, sap, secretion
混|mix, blend, confuse
減|dwindle, decrease, reduce, decline, curtail, get hungry
測|fathom, plan, scheme, measure
準|semi-, correspond to, proportionate to, conform, imitate
演|performance, act, play, render, stage
潔|undefiled, pure, clean, righteous, gallant
災|disaster, calamity, woe, curse, evil
燃|burn, blaze, glow
版|printing block, printing plate, edition, impression, label
犯|crime, sin, offense
状|status quo, conditions, circumstances, form, appearance
独|single, alone, spontaneously, Germany
率|ratio, rate, proportion, %, coefficient, factor
現|present, existing, actual
留|detain, fasten, halt, stop
略|abbreviation, omission, outline, shorten, capture, plunder
益|benefit, gain, profit, advantage
眼|eyeball
破|rend, rip, tear, break, destroy, defeat, frustrate
確|assurance, firm, tight, hard, solid, confirm, clear, evident
示|show, indicate, point out, express, display
祖|ancestor, pioneer, founder
禁|prohibition, ban, forbid
移|shift, move, change, drift, catch (cold, fire), pass into
程|extent, degree, law, formula, distance, limits, amount
税|tax, duty
築|fabricate, build, construct
精|refined, ghost, fairy, energy, vitality, semen, excellence, purity, skill
素|elementary, principle, naked, uncovered
経|sutra, longitude, pass thru, expire, warp
統|overall, relationship, ruling, governing
絶|discontinue, beyond, sever, cut off, abstain, interrupt, suppress
綿|cotton
総|general, whole, all, full, total
編|compilation, knit, plait, braid, twist, editing, completed poem, part of a book
績|exploits, unreeling cocoons
織|weave, fabric
罪|guilt, sin, crime, fault, blame, offense
群|flock, group, crowd, herd, swarm, cluster
義|righteousness, justice, morality, honor, loyalty, meaning
耕|till, plow, cultivate
職|post, employment, work
肥|fertilizer, get fat, fertile, manure, pamper
能|ability, talent, skill, capacity
興|entertain, revive, retrieve, interest, pleasure
舌|tongue, reed, clapper
舎|cottage, inn, hut, house, mansion
術|art, technique, skill, means, trick, resources, magic
衛|defense, protection
製|made in..., manufacture
複|duplicate, double, compound, multiple
規|standard, measure
解|unravel, notes, key, explanation, understanding, untie, undo, solve, answer, cancel, absolve, explain, minute
設|establishment, provision, prepare
許|permit, approve
証|evidence, proof, certificate
評|evaluate, criticism, comment
講|lecture, club, association
謝|apologize, thank, refuse
識|discriminating, know, write
護|safeguard, protect
豊|bountiful, excellent, rich
財|property, money, wealth, assets
貧|poverty, poor
責|blame, condemn, censure
貸|lend
貿|trade, exchange
賀|congratulations, joy
資|assets, resources, capital, funds, data, be conducive to, contribute to
賛|approve, praise, title or inscription on picture, assist, agree with
質|substance, quality, matter, temperament
輸|transport, send, be inferior
述|mention, state, speak, relate
迷|astray, be perplexed, in doubt, lost, err, illusion
退|retreat, withdraw, retire, resign, repel, expel, reject
逆|inverted, reverse, opposite, wicked
造|create, make, structure, physique
過|overdo, exceed, go beyond, error
適|suitable, occasional, rare, qualified, capable
酸|acid, bitterness, sour, tart
鉱|mineral, ore
銅|copper
銭|coin, .01 yen, money
防|ward off, defend, protect, resist
限|limit, restrict, to best of ability
険|precipitous, inaccessible place, impregnable position, steep place, sharp eyes
際|occasion, side, edge, verge, dangerous, adventurous, indecent, time, when
雑|miscellaneous
非|un-, mistake, negative, injustice, non-
預|deposit, custody, leave with, entrust to
領|jurisdiction, dominion, territory, fief, reign
額|forehead, tablet, plaque, framed picture, sum, amount, volume
飼|domesticate, raise, keep, feed
並|row, and, besides, as well as, line up, rank with, rival, equal
乱|riot, war, disorder, disturb
乳|milk, breasts
亡|deceased, the late, dying, perish
仁|humanity, virtue, benevolence, charity, man, kernel
供|submit, offer, present, serve (meal), accompany
俳|haiku, actor
値|price, cost, value
傷|wound, hurt, injure, impair, pain, injury, cut, gash, scar, weak point
優|tenderness, excel, surpass, actor, superiority, gentleness
党|party, faction, clique
冊|tome, counter for books, volume
処|dispose, manage, deal with, sentence, condemn, act, behave
刻|engrave, cut fine, chop, hash, mince, time, carving
割|proportion, comparatively, divide, cut, separate, split
創|genesis, wound, injury, hurt, start, originate
劇|drama, play
勤|diligence, become employed, serve
危|dangerous, fear, uneasy
卵|egg, ovum, spawn, roe
厳|stern, strictness, severity, rigidity
収|income, obtain, reap, pay, supply, store
后|empress, queen, after, behind, back, later
否|negate, no, noes, refuse, decline, deny
吸|suck, imbibe, inhale, sip
呼|call, call out to, invite
善|virtuous, good, goodness
困|quandary, become distressed, annoyed
垂|droop, suspend, hang, slouch
城|castle
域|range, region, limits, stage, level
奏|play music, speak to a ruler, complete
奮|stirred up, be invigorated, flourish
姿|figure, form, shape
存|suppose, be aware of, believe, feel
孝|filial piety, child's respect
宅|home, house, residence, our house, my husband
宇|eaves, roof, house, heaven
宗|religion, sect, denomination, main point, origin, essence
宙|mid-air, air, space, sky, memorization, interval of time
宝|treasure, wealth, valuables
宣|proclaim, say, announce
密|secrecy, density (pop), minuteness, carefulness
寸|measurement, foot/10
専|specialty, exclusive, mainly, solely
射|shoot, shine into, onto, archery
将|leader, commander, general, admiral, or, and again, soon, from now on, just about
尊|revered, valuable, precious, noble, exalted
就|concerning, settle, take position, depart, study, per
尺|shaku, Japanese foot, measure, scale, rule
届|deliver, reach, arrive, report, notify, forward
展|unfold, expand
層|stratum, social class, layer, story, floor
己|self, snake, serpent
巻|scroll, volume, book, part, roll up, wind up, tie, coil, counter for texts (on book scrolls)
幕|curtain, bunting, act of play
干|dry, parch
幼|infancy, childhood
庁|government office
座|squat, seat, cushion, gathering, sit
延|prolong, stretching
律|rhythm, law, regulation, gauge, control
従|accompany, obey, submit to, comply, follow, secondary, incidental, subordinate
忘|forget
忠|loyalty, fidelity, faithfulness
憲|constitution, law
我|ego, I, selfish, our, oneself
批|criticism, strike
担|shouldering, carry, raise, bear
拝|worship, adore, pray to
拡|broaden, extend, expand, enlarge
捨|discard, throw away, abandon, resign, reject, sacrifice
探|grope, search, look for
推|conjecture, infer, guess, suppose, support
揮|brandish, wave, wag, swing, shake
操|maneuver, manipulate, operate, steer, chastity, virginity, fidelity
敬|awe, respect, honor, revere
映|reflect, reflection, projection
晩|nightfall, night
暖|warmth
暮|livelihood, make a living, spend time
朗|melodious, clear, bright, serene, cheerful
机|desk, table
枚|sheet of..., counter for flat thin objects or sheets
染|dye, color, paint, stain, print
株|stocks, stump, shares, stock, counter for small plants
棒|rod, stick, cane, pole, club, line
模|imitation, copy, mock
権|authority, power, rights
樹|timber trees, wood
欲|longing, covetousness, greed, passion, desire, craving
段|grade, steps, stairs
沿|run alongside, follow along, run along, lie along
泉|spring, fountain
洗|wash, inquire into, probe
派|faction, group, party, clique, sect, school
済|finish, come to an end, excusable, need not
源|source, origin
潮|tide, salt water, opportunity
激|violent, get excited, enraged, chafe, incite
灰|ashes, puckery juice, cremate
熟|mellow, ripen, mature, acquire skill
片|one-sided, leaf, sheet
班|squad, corps, unit, group
異|uncommon, queerness, strangeness, wonderful, curious, unusual
疑|doubt, distrust, be suspicious, question
痛|pain, hurt, damage, bruise
皇|emperor
盛|boom, prosper, copulate
盟|alliance, oath
看|watch over, see
砂|sand
磁|magnet, porcelain
私|private, I, me
秘|secret, conceal
穀|cereals, grain
穴|hole, aperture, slit, cave, den
窓|window, pane
筋|muscle, sinew, tendon, fiber, plot, plan, descent
策|scheme, plan, policy, step, means
簡|simplicity, brevity
糖|sugar
系|lineage, system
紅|crimson, deep red
納|settlement, obtain, reap, pay, supply, store
純|genuine, purity, innocence, net (profit)
絹|silk
縦|vertical, length, height, self-indulgent, wayward
縮|shrink, contract, shrivel, wrinkle, reduce
署|signature, govt office, police station
翌|the following, next
聖|holy, saint, sage, master, priest
肺|lungs
背|stature, height, back, behind, disobey, defy, go back on, rebel
胸|bosom, breast, chest, heart, feelings
脳|brain, memory
腹|abdomen, belly, stomach
臓|entrails, viscera, bowels
臨|look to, face, meet, confront, attend, call on
至|climax, arrive, proceed, reach, attain, result in
若|young, if, perhaps, possibly, low number, immature
著|renowned, publish, write, remarkable, phenomenal, put on, don, wear, arrival, finish (race), counter for suits of clothing, literary work
蒸|steam, heat, sultry, foment, get musty
蔵|storehouse, hide, own, have, possess
蚕|silkworm
衆|masses, great numbers, multitude, populace
裁|tailor, judge, decision, cut out (pattern)
装|attire, dress, pretend, disguise, profess
裏|back, amidst, in, reverse, inside, palm, sole, rear, lining, wrong side
補|supplement, supply, make good, offset, compensate, assistant, learner
視|inspection, regard as, see, look at
覧|perusal, see
討|chastise, attack, defeat, destroy, conquer
訪|call on, visit, look up, offer sympathy
訳|translate, reason, circumstance, case
詞|part of speech, words, poetry
誌|document, records
認|acknowledge, witness, discern, recognize, appreciate, believe
誕|nativity, be born, declension, lie, be arbitrary
誠|sincerity, admonish, warn, prohibit, truth, fidelity
誤|mistake, err, do wrong, mislead
論|argument, discourse
諸|various, many, several, together
警|admonish, commandment
貴|precious, value, prize, esteem, honor
賃|fare, fee, hire, rent, wages, charge
遺|bequeath, leave behind, reserve
郵|mail, stagecoach stop
郷|home town, village, native place, district
針|needle, pin, staple, stinger
鋼|steel
閉|closed, shut
閣|tower, tall building, palace
降|descend, precipitate, fall, surrender
陛|highness, steps (of throne)
除|exclude, division (x/3), remove, abolish, cancel, except
障|hinder, hurt, harm
難|difficult, impossible, trouble, accident, defect
革|leather, become serious, skin, hide, pelt
頂|place on the head, receive, top of head, top, summit, peak
骨|skeleton, bone, remains, frame
歳|year-end, age, occasion, opportunity
与|bestow, participate in, give, award, impart, provide, cause, gift, godsend
違|difference, differ
渡|transit, ford, ferry, cross, import, deliver, diameter, migrate
突|stab, protruding, thrusting, thrust, pierce, prick
捕|catch, capture
迎|welcome, meet, greet
彼|he, that, the
舞|dance, flit, circle, wheel
込|crowded, mixture, in bulk, included, (kokuji)
頼|trust, request
途|route, way, road
抜|slip out, extract, pull out, pilfer, quote, remove, omit
婚|marriage
浮|floating, float, rise to surface
押|push, stop, check, subdue, attach, seize, weight, shove, press, seal, do in spite of
倒|overthrow, fall, collapse, drop, break down
払|pay, clear out, prune, banish, dispose of
遅|slow, late, back, later
更|grow late, night watch, sit up late, of course
抱|embrace, hug, hold in arms
恐|fear, dread, awe
戻|re-, return, revert, resume, restore, go backwards
越|surpass, cross over, move to, exceed, Vietnam
互|mutually, reciprocally, together
逃|escape, flee, shirk, evade, set free
緒|thong, beginning, inception, end, cord, strap
掛|hang, suspend, depend, arrive at, tax
到|arrival, proceed, reach, attain, result in
寝|lie down, sleep, rest, bed, remain unsold
盗|steal, rob, pilfer
御|honorable, manipulate, govern
吹|blow, breathe, puff, emit, smoke
娘|daughter, girl
怒|angry, be offended
杯|cupfuls, wine glass, glass, toast
疲|exhausted, tire, weary
皆|all, everything
煙|smoke
眠|sleep, die, sleepy
怖|dreadful, be frightened, fearful
髪|hair of the head
忙|busy, occupied, restless
靴|shoes
恥|shame, dishonor
偶|accidentally, even number, couple, man & wife, same kind
偉|admirable, greatness, remarkable, conceited, famous, excellent
猫|cat
幾|how many, how much, how far, how long
環|ring, circle, link, wheel
欧|Europe
被|incur, cover, veil, brood over, shelter, wear, put on, be exposed (film), receiving
含|include, bear in mind, understand, cherish
況|condition, situation
湾|gulf, bay, inlet
捜|search, look for, locate
超|transcend, super-, ultra-
療|heal, cure
介|jammed in, shellfish, mediate, concern oneself with
販|marketing, sell, trade
幅|hanging scroll, width
般|carrier, carry, all
換|interchange, period, charge, change?
占|fortune telling, divine, forecast, occupy, hold, have, get, take
伸|expand, stretch, extend, lengthen, increase
爆|bomb, burst open, pop, split
普|universal, wide(ly), generally, Prussia
齢|age
了|complete, finish
絡|entwine, coil around, get caught in
募|recruit, campaign, gather (contributions), enlist, grow violent
昇|rise up
香|incense, smell, perfume
巨|gigantic, big, large, great
震|quake, shake, tremble, quiver, shiver
触|contact, touch, feel, hit, proclaim, announce, conflict
依|reliant, depend on, consequently, therefore, due to
汚|dirty, pollute, disgrace, rape, defile
恵|favor, blessing, grace, kindness
傾|lean, incline, tilt, trend, wane, sink, ruin, bias
駐|stop-over, reside in, resident
紹|introduce, inherit, help
雇|employ, hire
替|exchange, spare, substitute, per-
贈|presents, send, give to, award to, confer on, presenting something
薄|dilute, thin, weak (tea)
奥|heart, interior
詰|packed, close, pressed, reprove, rebuke, blame
双|pair, set, comparison, no. of pairs
刺|thorn, pierce, stab, prick, sting, calling card
壁|wall, lining (stomach), fence
悩|trouble, worry, in pain, distress, illness
荒|laid waste, rough, rude, wild
硬|stiff, hard
埋|bury, be filled up, embedded
袋|sack, bag, pouch
封|seal, closing
賢|intelligent, wise, wisdom, cleverness
腕|arm, ability, talent
較|contrast, compare
床|bed, floor, padding, tatami
柔|tender, weakness, gentleness, softness
殿|Mr., hall, mansion, palace, temple, lord
濃|concentrated, thick, dark, undiluted
肩|shoulder
零|zero, spill, overflow, nothing, cipher
泊|overnight, put up at, ride at anchor, 3-day stay
甘|sweet, coax, pamper, be content, sugary
掃|sweep, brush
掘|dig, delve, excavate
軟|soft
沈|sink, be submerged, subside, be depressed, aloes
凍|frozen, congeal, refrigerate
恋|romance, in love, yearn for, miss, darling
郊|outskirts, suburbs, rural area
腰|loins, hips, waist, low wainscoting
踊|jump, dance, leap, skip
珍|rare, curious, strange
狭|cramped, narrow, contract, tight
喫|consume, eat, drink, smoke, receive (a blow)
溶|melt, dissolve, thaw
涙|tears, sympathy
匹|equal, head, counter for small animals, roll of cloth
鋭|pointed, sharpness, edge, weapon, sharp, violent
塗|paint, plaster, daub, smear, coating
軒|flats, counter for houses, eaves
叫|shout, exclaim, yell
乾|drought, dry, dessicate, drink up, heaven, emperor
祈|pray, wish
汗|sweat, perspire
湿|damp, wet, moist
咲|blossom, bloom
召|seduce, call, send for, wear, put on, ride in, buy, eat, drink, catch (cold)
脂|fat, grease, tallow, lard, rosin, gum, tar
肌|texture, skin, body, grain
鈍|dull, slow, foolish, blunt
泥|mud, mire, adhere to, be attached to
隅|corner, nook
辛|spicy, bitter, hot, acrid
磨|grind, polish, scour, improve, brush (teeth)
姓|surname
筒|cylinder, pipe, tube, gun barrel, sleeve
粒|grains, drop, counter for tiny particles
畳|tatami mat, counter for tatami mats, fold, shut up, do away with
膚|skin, body, grain, texture, disposition
濯|laundry, wash, pour on, rinse
塔|pagoda, tower, steeple
沸|seethe, boil, ferment, uproar, breed
菓|candy, cakes, fruit
帽|cap, headgear
枯|wither, die, dry up, be seasoned
涼|refreshing, nice and cool
舟|boat, ship
符|token, sign, mark, tally, charm
憎|hate, detest
肯|agreement, consent, comply with
燥|parch, dry up
畜|livestock, domestic fowl and animals
坊|boy, priest's residence, priest, your, his, or her boy
挟|pinch, between
曇|cloudy weather, cloud up
滴|drip, drop
伺|pay respects, visit, ask, inquire, question, implore
企|undertake, scheme, design, attempt, plan
藤|wistaria
沢|swamp
援|abet, help, save
施|alms, apply bandages, admin 1st aid
井|well
鮮|fresh, vivid, clear, brilliant, Korea
監|oversee, official, govt office, rule, administer
審|hearing, judge, trial
訴|accusation, sue, complain of pain, appeal to
影|shadow, silhouette, phantom
撃|beat, attack, defeat, conquer
佐|assistant, help
核|nucleus, core, kernel
融|dissolve, melt
渉|ford, ferry, port
響|echo, also N5116, sound, resound, ring, vibrate
請|solicit, invite, ask
攻|aggression, attack
崎|promontory, cape, spit
督|coach, command, urge, lead, supervise
催|sponsor, hold (a meeting), give (a dinner)
及|reach out, exert, exercise, cause
離|detach, separation, disjoin, digress
摘|pinch, pick, pluck, trim, clip, summarize
郎|son, counter for sons
振|shake, wave, wag, swing
献|offering, no. of drinks, present, offer
維|fiber, tie, rope
浜|seacoast, beach, seashore
塁|bases, fort, rampart, walls, base(ball)
邦|home country, country, Japan
遣|dispatch, send, give, donate, do, undertake
抗|confront, resist, defy, oppose
雄|masculine, male, hero, leader, superiority, excellence
緊|tense, solid, hard, reliable, tight
廃|abolish, obsolete, cessation, discarding, abandon
江|creek, inlet, bay
僚|colleague, official, companion
吉|good luck, joy, congratulations
踏|step, trample, carry through, appraise, evade payment
壊|demolition, break, destroy
債|bond, loan, debt
儀|ceremony, rule, affair, case, a matter
継|inherit, succeed, patch, graft (tree)
闘|fight, war
葬|interment, bury, shelve
避|evade, avoid, avert, ward off, shirk, shun
逮|apprehend, chase
迫|urge, force, imminent, spur on
惑|beguile, delusion, perplexity
崩|crumble, die, demolish, level
聴|listen, headstrong, naughty, careful inquiry
脱|undress, removing, escape from, get rid of, be left out, take off
患|afflicted, disease, suffer from, be ill
締|tighten, tie, shut, lock, fasten
執|tenacious, take hold, grasp, take to heart
房|tassel, tuft, fringe, bunch, lock (hair), segment (orange), house, room
撤|remove, withdraw, disarm, dismantle, reject, exclude
削|plane, sharpen, whittle, pare
措|set aside, give up, suspend, discontinue, lay aside, except
載|load, multiplication, power, 10**44
陣|camp, battle array, ranks, position
為|do, change, make, benefit, welfare, be of use, reach to, try, practice, cost, serve as, good, advantage, as a result of
抑|repress, well, now, in the first place, push, shove, press, seal, do in spite of
奈|Nara, what?
択|choose, select, elect, prefer
秀|excel, excellence, beauty, surpass
徴|indications, sign, omen, symptom, collect, seek, refer to, question
弾|bullet, twang, flip, snap
償|reparation, make up for, recompense, redeem
拠|foothold, based on, follow, therefore
拒|repel, refuse, reject, decline
刑|punish, penalty, sentence, punishment
塚|hillock, mound
致|doth, do, send, forward, cause, exert, incur, engage
繰|winding, reel, spin, turn (pages), look up, refer to
尾|tail, end, no. of fish, lower slope of mtn
描|sketch, compose, write, draw, paint
鈴|small bell, buzzer
盤|tray, shallow bowl, platter, tub, board, phonograph record
項|paragraph, nape of neck, clause, item, term (expression)
喪|miss, mourning
伴|consort, accompany, bring with, companion
懸|suspend, hang, 10%, install, depend, consult
契|pledge, promise, vow
掲|put up (a notice), put up, hoist, display, hang out, publish, describe
躍|leap, dance, skip
棄|abandon, throw away, discard, resign, reject, sacrifice
邸|residence, mansion
籍|enroll, domiciliary register, membership
還|send back, return
慮|prudence, thought, concern, consider, deliberate, fear
枠|frame, framework, spindle, spool, bounding-box, (kokuji)
露|dew, tears, mortality, flimsiness
沖|open sea, offing, rise high into sky
緩|slacken, loosen, relax, lessen, be moderate, ease
需|demand, request, need
購|subscription, buy
充|allot, fill
跡|tracks, mark, print, impression
貢|tribute, support, finance
鹿|deer
却|instead, on the contrary, rather
端|edge, origin, end, point, border, verge, cape
獲|seize, get, find, earn, acquire, can, may, able to
併|join, get together, unite, collective
徹|penetrate, clear, pierce, strike home, sit up (all night)
衝|collide, brunt, highway, opposition (astronomy), thrust, pierce, stab, prick
焦|char, hurry, impatient, irritate, burn, scorch, singe
奪|rob, take by force, snatch away, dispossess, plunder, usurp
浦|bay, creek, inlet, gulf, beach, seacoast
析|chop, divide, tear, analyze
譲|defer, turnover, transfer, convey
称|appellation, praise, admire, name, title, fame
挑|challenge, contend for, make love to
誘|entice, lead, tempt, invite, ask, call for, seduce, allure
紛|distract, be mistaken for, go astray, divert
促|stimulate, urge, press, demand, incite
慎|humility, be careful, discrete, prudent
控|withdraw, draw in, hold back, refrain from, be moderate
握|grip, hold, mould sushi, bribe
俊|sagacious, genius, excellence
渋|astringent, hesitate, reluctant, have diarrhea
銃|gun, arms
携|portable, carry (in hand), armed with, bring along
診|checkup, seeing, diagnose, examine
託|consign, requesting, entrusting with, pretend, hint
撮|snapshot, take pictures
侵|encroach, invade, raid, trespass, violate
括|fasten, tie up, arrest, constrict
駆|drive, run, gallop, advance, inspire, impel
透|transparent, permeate, filter, penetrate
津|haven, port, harbor, ferry
稲|rice plant
裂|split, rend, tear
敏|cleverness, agile, alert
是|just so, this, right, justice
排|repudiate, exclude, expel, reject
裕|abundant, rich, fertile
堅|strict, hard, solid, tough, tight, reliable
芝|turf, lawn
綱|hawser, class (genus), rope, cord, cable
扱|handle, entertain, thresh, strip
顧|look back, review, examine oneself, turn around
訟|sue, accuse
戒|commandment
祉|welfare, happiness
誉|reputation, praise, honor, glory
歓|delight, joy
勧|persuade, recommend, advise, encourage, offer
騒|boisterous, make noise, clamor, disturb, excite
閥|clique, lineage, pedigree, faction, clan
甲|armor, high (voice), A grade, 1st class, former, instep, carapace
縄|straw rope, cord
揺|swing, shake, sway, rock, tremble, vibrate
免|excuse, dismissal
既|previously, already, long ago
薦|recommend, mat, advise, encourage, offer
隣|neighboring
華|splendor, flower, petal, shine, luster, ostentatious, showy, gay, gorgeous
範|pattern, example, model
隠|conceal, hide, cover
哲|philosophy, clear
杉|cedar, cryptomeria
釈|explanation
妥|gentle, peace, depravity
威|intimidate, dignity, majesty, menace, threaten
豪|overpowering, great, powerful, excelling, Australia
熊|bear
滞|stagnate, be delayed, overdue, arrears
微|delicate, minuteness, insignificance
隆|hump, high, noble, prosperity
症|symptoms, illness
暫|temporarily, a while, moment, long time
肝|liver, pluck, nerve, chutzpah
喚|yell, cry, scream
妙|exquisite, strange, queer, mystery, miracle, excellent, delicate, charming
索|cord, rope
襲|attack, advance on, succeed to
懇|sociable, kind, courteous, hospitable, cordial
柄|design, pattern, build, nature, handle, crank, grip, knob, shaft
驚|wonder, be surprised, frightened, amazed
麻|hemp, flax
剤|dose, medicine, drug
瀬|rapids, current, torrent, shallows, shoal
趣|gist, proceed to, tend, become
陥|collapse, fall into, cave in, fall (castle), slide into
斎|purification, Buddhist food, room, worship, avoid, alike
貫|pierce, 8 1/3lbs, penetrate, brace
仙|hermit, wizard, cent
慰|consolation, amusement, seduce, cheer, make sport of, comfort, console
旬|decameron, 10day period, season (for specific products
兼|concurrently, and
旨|delicious, relish, show a liking for, purport, will, clever, expert
即|instant, namely, as is, conform, agree, adapt
柳|willow
偽|falsehood, lie, deceive, pretend, counterfeit, forgery
覇|hegemony, supremacy, leadership, champion
詳|detailed, full, minute, accurate, well-informed
抵|resist, reach, touch
脅|threaten, coerce
茂|overgrown, grow thick, be luxuriant
犠|sacrifice
距|long-distance
雅|gracious, elegant, graceful, refined
飾|decorate, ornament, adorn, embellish
網|netting, network
竜|dragon, imperial
繁|luxuriant, thick, overgrown, frequency, complexity, trouble
翼|wing, plane, flank
潟|lagoon
魅|fascination, charm, bewitch
嫌|dislike, detest, hate
斉|adjusted, alike, equal, similar variety of
敷|spread, pave, sit, promulgate
擁|hug, embrace, possess, protect, lead
圏|sphere, circle, radius, range
罰|penalty, punishment
滅|destroy, ruin, overthrow, perish
礎|cornerstone, foundation stone
腐|rot, decay, sour
脚|skids, leg, undercarriage
尽|exhaust, use up, run out of, befriend, serve
僕|me, I (male)
滑|slippery, slide, slip, flunk
孤|orphan, alone
炎|inflammation, flame, blaze
賠|compensation, indemnify
寿|longevity, congratulations, ones natural life
頑|stubborn, foolish, firmly
鎖|chain, irons, connection
彩|coloring, paint, makeup
摩|chafe, rub, polish, grind, scrape
励|encourage, be diligent, inspire
輝|radiance, shine, sparkle, gleam, twinkle
蓄|amass, keeping a concubine, phonograph
軸|axis, pivot, stem, stalk, counter for book scrolls
巡|patrol, go around, circumference
稼|earnings, work, earn money
瞬|wink, blink, twinkle
砲|cannon, gun
噴|erupt, spout, emit, flush out
誇|boast, be proud, pride, triumphantly
祥|auspicious, happiness, good omen
牲|animal sacrifice, offering
秩|regularity, salary, order
帝|sovereign, the emperor, god, creator
唆|tempt, seduce, instigate, promote
阻|thwart, separate from, prevent, obstruct, deter, impede
泰|peaceful, calm, peace, easy, Thailand
賄|bribe, board, supply, finance
撲|slap, strike, hit, beat, tell, speak
堀|ditch, moat, canal
菊|chrysanthemum
絞|strangle, constrict, wring
縁|affinity, relation, connection, edge, border, verge, brink
唯|solely, only, merely, simply
膨|swell, get fat, thick
耐|-proof, enduring
塾|cram school, private school
漏|leak, escape, time
慶|jubilation, congratulate, rejoice, be happy
猛|fierce, rave, rush, become furious, wildness, strength
芳|perfume, balmy, flavorable, fragrant
懲|penal, chastise, punish, discipline
剣|sabre, sword, blade, clock hand
彰|patent, clear
棋|chess piece, Japanese chess, shogi
恒|constancy, always
揚|hoist, fry in deep fat
冒|risk, face, defy, dare, damage, assume (a name)
倫|ethics, companion
陳|exhibit, state, relate, explain
憶|recollection, think, remember
潜|submerge, conceal, hide, lower (voice), hush
梨|pear tree
克|overcome, kindly, skillfully
岳|point, peak, mountain
概|outline, condition, approximation, generally
拘|arrest, seize, concerned, adhere to, despite
黙|silence, become silent, stop speaking, leave as is
須|ought, by all means, necessarily
偏|partial, side, left-side radical, inclining, biased
雰|atmosphere, fog
遇|interview, treat, entertain, receive, deal with
諮|consult with
卓|eminent, table, desk, high
亀|tortoise, turtle
糧|provisions, food, bread
簿|register, record book
炉|hearth, furnace, kiln, reactor
殊|particularly, especially, exceptionally
殖|augment, increase, multiply, raise
艦|warship
輩|comrade, fellow, people, companions
奇|strange, strangeness, curiousity
慢|ridicule, laziness
鶴|crane, stork
謀|conspire, cheat, impose on, plan, devise, scheme, have in mind, deceive
拍|clap, beat (music)
丈|length, 10feet, measure, Mr., Ms., height, stature, all (one has), only, that's all, merely
寛|tolerant, leniency, generosity, relax, feel at home, be at ease, broadminded
覆|capsize, cover, shade, mantle, be ruined
胞|placenta, sac, sheath
隔|isolate, alternate, distance, separate, gulf
浄|clean, purify, cleanse, exorcise, Manchu Dynasty
没|drown, sink, hide, fall into, disappear, die
暇|spare time, rest, leisure, time, leave of absence
貞|upright, chastity, constancy, righteousness
鑑|specimen, take warning from, learn from
陰|shade, yin, negative, sex organs, secret, shadow
銘|inscription, signature (of artisan)
随|follow, though, notwithstanding, while, during, both, all, obey, submit to, comply, at the mercy of (the waves)
烈|ardent, violent, vehement, furious, severe, extreme
尋|inquire, fathom, look for
稿|draft, copy, manuscript, straw
丹|rust-colored, red, read lead, pills
啓|disclose, open, say
丘|hill, knoll
棟|ridgepole, ridge
壌|lot, earth, soil
漫|cartoon, involuntarily, in spite of oneself, corrupt
玄|mysterious, occultness
粘|sticky, glutinous, greasy, persevere
悟|enlightenment, perceive, discern, realize, understand
舗|shop, store
妊|pregnancy
騰|inflation, advancing, going
遂|consummate, accomplish, attain, commit (suicide)
狂|lunatic, insane, crazy, confuse
岐|branch off, fork in road, scene, arena, theater
緯|horizontal, woof, left & right, latitude
培|cultivate, foster
衰|decline, wane, weaken
艇|rowboat, small boat
屈|yield, bend, flinch, submit
淡|thin, faint, pale, fleeting
抽|pluck, pull, extract, excel
披|expose, open
廷|courts, imperial court, government office
錦|brocade, fine dress, honors
准|quasi-, semi-, associate
奨|exhort, urge, encourage
浸|immersed, soak, dip, steep, moisten, wet, dunk
剰|surplus, besides
胆|gall bladder, courage, pluck, nerve
繊|slender, fine, thin kimono
駒|pony, horse, colt
虚|void, emptiness, unpreparedness, crack, fissure, untruth
霊|spirits, soul
悔|repent, regret
諭|rebuke, admonish, charge, warn, persuade
惨|wretched, disaster, cruelty, harsh
虐|tyrannize, oppress
翻|flip, turn over, wave, flutter, change (mind)
墜|crash, fall (down)
沼|marsh, lake, bog, swamp, pond
据|set, lay a foundation, install, equip, squat down, sit down
徐|gradually, slowly, deliberately, gently
搭|board, load (a vehicle), ride
盾|shield, escutcheon, pretext
滝|waterfall, rapids, cascade
軌|rut, wheel, track, model, way of doing
妨|disturb, prevent, hamper, obstruct
擦|grate, rub, scratch, scrape, chafe, scour
鯨|whale
荘|villa, inn, cottage, feudal manor
諾|consent, assent, agreement
雷|thunder, lightening bolt
漂|drift, float (on liquid)
懐|pocket, feelings, heart, yearn, miss someone, become attached to, bosom, breast
勘|intuition, perception
栽|plantation, planting
拐|kidnap, falsify
駄|burdensome, pack horse, horse load, send by horse
添|annexed, accompany, marry, suit, meet, satisfy, attach, append, garnish, imitate
冠|crown, best, peerless
斜|diagonal, slanting, oblique
浪|wandering, waves, billows
亜|Asia, rank next, come after, -ous
詐|lie, falsehood, deceive, pretend
壇|podium, stage, rostrum, terrace
勲|meritorious deed, merit
魔|witch, demon, evil spirit
酬|repay, reward, retribution
紫|purple, violet
紋|family crest, figures
卸|wholesale
欄|column, handrail, blank, space
逸|deviate, idleness, leisure, miss the mark, evade, elude, parry, diverge
涯|horizon, shore
拓|clear (the land), open, break up (land)
瓶|flower pot, bottle, vial, jar, jug, vat, urn
獄|prison, jail
尚|esteem, furthermore, still, yet
彫|carve, engrave, chisel
穏|calm, quiet, moderation
顕|appear, existing
巧|adroit, skilled, ingenuity
矛|halberd, arms, festival float
垣|hedge, fence, wall
欺|deceit, cheat, delude
釣|angling, fish, catch, allure, ensnare
缶|tin can, container
粧|cosmetics, adorn (ones person)
隻|vessels, no. of ships, fish, birds, arrows, one of a pair
粛|solemn, quietly, softly
愚|foolish, folly, absurdity, stupid
遭|encounter, meet, party, association, interview, join
架|erect, frame, mount, support, shelf, construct
鬼|ghost, devil
庶|commoner, all, bastard
稚|immature, young
滋|nourishing, more & more, be luxuriant, planting, turbidity
幻|phantasm, vision, dream, illusion, apparition
煮|boil, cook
姫|princess
誓|vow, swear, pledge
把|grasp, faggot, bunch, counter for bundles
践|tread, step on, trample, practice, carry through
呈|display, offer, present, send, exhibit
疎|alienate, rough, neglect, shun, sparse
仰|face-up, look up, depend, seek, respect, rever, drink, take
剛|sturdy, strength
疾|rapidly
征|subjugate, attack the rebellious, collect taxes
砕|smash, break, crush, familiar, popular
謡|noh chanting
嫁|marry into, bride
謙|self-effacing, humble oneself, condescend, be modest
嘆|sigh, lament, moan, grieve
菌|germ, fungus, bacteria
鎌|sickle, scythe, trick
頻|repeatedly, recur
琴|harp, koto
棚|shelf, ledge, rack, mount, mantle, trellis
酷|cruel, severe, atrocious, unjust
宰|superintend, manager, rule
廊|corridor, hall, tower
寂|loneliness, quietly, mellow, mature, death of a priest
伏|prostrated, bend down, bow, cover, lay (pipes)
碁|Go
俗|vulgar, customs, manners, worldliness, mundane things
漠|vague, obscure, desert, wide
邪|wicked, injustice, wrong
晶|sparkle, clear, crystal
墨|black ink, India ink, ink stick, Mexico
鎮|tranquilize, ancient peace-preservation centers
洞|den, cave, excavation
履|footgear, shoes, boots, put on (the feet
劣|inferiority, be inferior to, be worse
那|what?
殴|assault, hit, beat, thrash
娠|with child, pregnancy
奉|observance, offer, present, dedicate
憂|melancholy, grieve, lament, be anxious, sad, unhappy
朴|crude, simple, plain, docile
亭|pavilion, restaurant, mansion, arbor, cottage, vaudeville, music hall, stage name
怪|suspicious, mystery, apparition
酔|drunk, feel sick, poisoned, elated, spellbound
惜|pity, be sparing of, frugal, stingy, regret
穫|harvest, reap
佳|excellent, beautiful, good, pleasing, skilled
潤|wet, be watered, profit by, receive benefits, favor, charm, steep
悼|lament, grieve over
乏|destitution, scarce, limited
該|above-stated, the said, that specific
赴|proceed, get, become, tend
桑|mulberry
髄|marrow, pith
虎|tiger, drunkard
盆|basin, lantern festival, tray
穂|ear, ear (grain), head, crest (wave)
壮|robust, manhood, prosperity
堤|dike, bank, embankment
飢|hungry, starve
傍|bystander, side, besides, while, nearby, 3rd person
疫|epidemic
累|accumulate, involvement, trouble, tie up, continually
痴|stupid, foolish
搬|conveyor, carry, transport
癒|healing, cure, quench (thirst), wreak
郭|enclosure, quarters, fortification, red-light district
尿|urine
凶|villain, evil, bad luck, disaster
吐|spit, vomit, belch, confess, tell (lies)
宴|banquet, feast, party
賓|V.I.P., guest
虜|captive, barbarian, low epithet for the enemy
陶|pottery, porcelain
鐘|bell, gong, chimes
憾|remorse, regret, be sorry
弥|all the more, increasingly
昆|descendants, elder brother
粗|coarse, rough, rugged
訂|revise, correct, decide
傘|umbrella
騎|equestrian, riding on horses, counter for equestrians
寧|rather, preferably
循|sequential, fellow
忍|endure, bear, put up with, conceal, secrete, spy, sneak
怠|neglect, laziness
如|likeness, like, such as, as if, better, best, equal
寮|dormitory, hostel, villa, tea pavillion
鉛|lead
珠|pearl, gem, jewel
凝|congeal, freeze, stiff, be absorbed in
苗|seedling, sapling, shoot
獣|animal, beast
哀|pathetic, grief, sorrow, pathos, pity, sympathize
跳|hop, leap up, spring, jerk, prance, buck, splash, sputter, snap
匠|artisan, workman, carpenter
蛇|snake, serpent, hard drinker
澄|lucidity, be clear, clear, clarify, settle, strain, look grave
縫|sew, stitch, embroider
僧|Buddhist priest, monk
眺|stare, watch, look at, see, scrutinize
唐|T'ang, China
呉|give, do something for
凡|mediocre
憩|recess, rest, relax, repose
媛|beautiful woman, princess
溝|gutter, ditch, sewer, drain, 10**32
恭|respect, reverent
刈|reap, cut, clip, trim, prune
睡|drowsy, sleep, die
錯|confused, mix, be in disorder
伯|chief, count, earl, uncle, Brazil
陵|mausoleum, imperial tomb
霧|fog, mist
魂|soul, spirit
弊|abuse, evil, vice, breakage
妃|queen, princess
舶|liner, ship
餓|starve, hungry, thirst
窮|hard up, destitute, suffer, perplexed, cornered
掌|manipulate, rule, administer, conduct, palm of hand
麗|lovely, companion
臭|stinking, ill-smelling, suspicious looking, odor, savor, fragrance, be fragrant, stink, glow, be bright
悦|ecstasy, joy, rapture
刃|blade, sword, edge
縛|truss, arrest, bind, tie, restrain
暦|calendar, almanac
宜|best regards, good
盲|blind, blind man, ignoramus
粋|chic, style, purity, essence, pith, cream, elite, choice
辱|embarrass, humiliate, shame
轄|control, wedge
猿|monkey
弦|bowstring, chord, hypotenuse
窒|plug up, obstruct
炊|cook, boil
洪|deluge, flood, vast
摂|vicarious, surrogate, act in addition to
飽|sated, tired of, bored, satiate
冗|superfluous, uselessness
桃|peach tree
狩|hunt, raid, gather
朱|vermilion, cinnabar, scarlet, red, bloody
渦|whirlpool, eddy, vortex
紳|sire, good belt, gentleman
枢|hinge, pivot, door
碑|tombstone, monument
鍛|forge, discipline, train
鼓|drum, beat, rouse, muster
裸|naked, nude, uncovered, partially clothed
猶|furthermore, still, yet
塊|clod, lump, chink, clot, mass
旋|rotation, go around
幣|cash, bad habit, humble prefix, gift, Shinto offerings of cloth, rope, cut paper
膜|membrane
扇|fan, folding fan
槽|vat, tub, tank
慈|mercy
伐|fell, strike, attack, punish
漬|pickling, soak, moisten, steep
糾|twist, ask, investigate, verify
墳|tomb, mound
坪|two-mat area, ~36 sq ft
紺|dark blue, navy
慌|disconcerted, be confused, lose one's head
娯|recreation, pleasure
羅|gauze, thin silk, Rome
峡|gorge, ravine
俸|stipend, salary
厘|rin, 1/10sen, 1/10bu
峰|summit, peak
醸|brew, cause
弔|condolences, mourning, funeral
乙|the latter, duplicate, strange, witty
汁|soup, juice, broth, sap, gravy, pus
尼|nun
遍|everywhere, times, widely, generally
衡|equilibrium, measuring rod, scale
薫|fragrant, be scented, smoke (cigs)
猟|game-hunting, shooting, game, bag
款|goodwill, article, section, friendship, collusion
閲|review, inspection, revision
偵|spy
喝|hoarse, scold
敢|daring, sad, tragic, pitiful, frail, feeble
胎|womb, uterus
酵|fermentation
憤|aroused, resent, be indignant, anger
豚|pork, pig
遮|intercept, interrupt, obstruct
扉|front door, title page, front page
硫|sulphur
赦|pardon, forgiveness
窃|stealth, steal, secret, private, hushed
泡|bubbles, foam, suds, froth
又|or again, furthermore, on the other hand
慨|rue, be sad, sigh, lament
紡|spinning
恨|regret, bear a grudge, resentment, malice, hatred
肪|obese, fat
扶|aid, help, assist
戯|frolic, play, sport
忌|mourning, abhor, detestable, death anniversary
濁|voiced, uncleanness, wrong, nigori, impurity
奔|bustle, run
斗|Big Dipper, 10 sho (vol), sake dipper
迅|swift, fast
肖|resemblance
鉢|bowl, rice tub, pot, crown
朽|decay, rot, remain in seclusion
殻|husk, nut shell
享|receive, undergo, answer (phone), take, get, catch
藩|clan, enclosure
沙|sand
媒|mediator, go-between
鶏|chicken
禅|Zen, silent meditation
嘱|entrust, request, send a message
胴|trunk, torso, hull (ship), hub of wheel
迭|transfer, alternation
挿|insert, put in, graft, wear (sword)
嵐|storm, tempest
椎|oak, mallet
陪|obeisance, follow, accompany, attend on
剖|divide
譜|musical score, music, note, staff, table, genealogy
悠|permanence, distant, long time, leisure
淑|graceful, gentle, pure
帆|sail
暁|daybreak, dawn, in the event
傑|greatness, excellence
奴|guy, slave, manservant, fellow
錠|lock, fetters, shackles
拳|fist
遷|transition, move, change
拙|bungling, clumsy, unskillful
侍|waiter, samurai, wait upon, serve
峠|mountain peak, mountain pass, climax, crest, (kokuji)
篤|fervent, kind, cordial, serious, deliberate
渇|thirst, dry up, parch
叔|uncle, youth
雌|feminine, female
堪|withstand, endure, support, resist
叙|confer, relate, narrate, describe
酢|vinegar, sour, acid, tart
吟|versify, singing, recital
逓|relay, in turn, sending
甚|tremendously, very, great, exceedingly
崇|adore, respect, revere, worship
漆|lacquer, varnish
岬|headland, cape, spit, promontory
癖|mannerism, habit, vice, trait, fault, kink
愉|pleasure, happy, rejoice
礁|reef, sunken rock
屯|barracks, police station, camp
姻|matrimony, marry
擬|mimic, aim (a gun) at, nominate, imitate
塀|fence, also N1103, wall
唇|lips
睦|intimate, friendly, harmonious
閑|leisure
幽|seclude, confine to a room
曹|cadet, friend
詠|recitation, poem, song, composing
卑|lowly, base, vile, vulgar
侮|scorn, despise, make light of, contempt
鋳|casting, mint
抹|rub, paint, erase
尉|military officer, jailer, old man, rank
隷|slave, servant, prisoner, criminal, follower
禍|calamity, misfortune, evil, curse
酪|dairy products, whey, broth, fruit juice
茎|stalk, stem
帥|commander, leading troops, governor
逝|departed, die
匿|hide, shelter, shield
襟|collar, neck, lapel
蛍|lightning-bug, firefly
寡|widow, minority, few
痢|diarrhea
庸|commonplace, ordinary, employment
坑|pit, hole
藍|indigo
賊|burglar, rebel, traitor, robber
搾|squeeze
畔|paddy-ridge, levee
唄|songs with samisen
孔|cavity, hole, slit, very, great, exceedingly
呂|spine, backbone
拷|torture, beat
嬢|lass, girl, Miss, daughter
渓|mountain stream, valley
翁|venerable old man
廉|bargain, reason, charge, suspicion, point, account, purity, honest, low price, cheap, rested, contented, peaceful
謹|discreet, reverently, humbly
瞳|pupil
湧|boil, ferment, seethe, uproar, breed
窯|kiln, oven, furnace
褒|praise, extol
醜|ugly, unclean, shame, bad looking
升|measuring box, 1.8 liter
殉|martyrdom, follow by resigning
煩|anxiety, trouble, worry, pain, ill, annoy, nuisance, irksome
劾|censure, criminal investigation
堕|degenerate, descend to, lapse into
租|tariff, crop tax, borrowing
桟|scaffold, cleat, frame, jetty, bolt (door)
婿|bridegroom, son-in-law
慕|pining, yearn for, love dearly, adore
罷|quit, stop, leave, withdraw, go
矯|rectify, straighten, correct, reform, cure, control, pretend, falsify
某|so-and-so, one, a certain, that person
囚|captured, criminal, arrest, catch
虹|rainbow
泌|ooze, flow, soak in, penetrate, secrete
漸|steadily, gradually advancing, finally, barely
蚊|mosquito
厄|unlucky, misfortune, bad luck, disaster
藻|seaweed, duckweed
嫡|legitimate wife, direct descent (non-bastard)
嚇|menacing, dignity, majesty, threaten
凸|convex, beetle brow, uneven
韻|rhyme, elegance, tone
霜|frost
硝|nitrate, saltpeter
勅|imperial order
棺|coffin, casket
儒|Confucian
愁|distress, grieve, lament, be anxious
楼|watchtower, lookout, high building
眉|eyebrow
薪|fuel, firewood, kindling
褐|brown, woollen kimono
賜|grant, gift, boon, results
繕|darning, repair, mend, trim, tidy up, adjust
栓|plug, bolt, cork, bung, stopper
凹|concave, hollow, sunken
艶|glossy, luster, glaze, polish, charm, colorful, captivating
錬|tempering, refine, drill, train, polish
衷|inmost, heart, mind, inside
逐|pursue, drive away, chase, accomplish, attain, commit
斥|reject, retreat, recede, withdraw, repel, repulse
詔|imperial edict
憧|yearnafter, long for, aspire to, admire, adore
宵|wee hours, evening, early night
妄|delusion, unnecessarily, without authority, reckless
酌|bartending, serving sake, the host, draw (water), ladle, scoop, pump
頒|partition, understand
肢|limb, arms & legs
謄|mimeograph, copy
嗣|heir, succeed
畝|furrow, 30 tsubo, ridge, rib
抄|extract, selection, summary, copy, spread thin
爽|refreshing, bracing, resonant, sweet, clear
惰|lazy, laziness
蛮|barbarian
旺|flourishing, successful, beautiful, vigorous
壱|I (one)
瑠|lapis lazuli
侯|marquis, lord, daimyo
弧|arc, arch, bow
附|affixed, attach, refer to, append
但|however, but
芋|potato
婆|old woman, grandma, wet nurse
倣|emulate, imitate
倹|frugal, economy, thrifty
繭|cocoon
謁|audience, audience (with king)
箇|counters for things
且|moreover, also, furthermore
伎|deed, skill
斤|axe, 1.32 lb, catty, counter for loaves of bread, axe radical (no. 69)
虞|fear, uneasiness, anxiety, concern, expectation, consideration
墾|ground-breaking, open up farmland
采|dice, form, appearance, take, coloring
璽|emperor's seal
爵|baron, peerage, court rank
遵|abide by, follow, obey, learn
塑|model, molding
汰|luxury, select
旦|nightbreak, dawn, morning
朕|majestic plural, imperial we
痘|pox, smallpox
弐|II, two, second
賦|levy, ode, prose, poem, tribute, installment
丙|third class, 3rd, 3rd calendar sign
耗|decrease
冶|peace, government, cure, heal, rule, subdue, patch
濫|excessive, overflow, spread out
吏|officer, an official
璃|glassy, lapis lazuli
瞭|clear
韓|Korea
岡|mount, hill, knoll
阪|heights, slope
狙|aim at, sight, shadow, stalk
埼|cape, spit, promontory
茨|briar, thorn
曽|once, before, formerly, ever, never, ex-
栃|horse chestnut, (kokuji)
阜|hill, mound (left-side B radical)
葛|arrowroot, kudzu
畿|capital, suburbs of capital
尻|buttocks, hips, butt, rear
柿|persimmon, shingle
腎|kidney
釜|kettle, cauldron, iron pot
脇|armpit, the other way, another place, flank, supporting role
鍋|pot, pan, kettle
瓦|tile, gram
挫|crush, break, sprain, discourage
誰|who, someone, somebody
俺|I, myself
痕|mark, foot print
袖|sleeve, wing (building), extension, give cold shoulder
妖|attractive, bewitching, calamity
闇|get dark, gloom, disorder
捉|catch, capture
賭|gamble, wager, bet
汎|pan-
頃|time, about, toward
謎|riddle, puzzle, enigma, hint, tip
爪|claw, nail, talon
鍵|key
臼|mortar
牙|tusk, fang
枕|pillow
丼|bowl, bowl of food
惧|to fear; to be afraid of
膳|small low table, tray
呪|spell, curse, charm, malediction
斬|beheading, kill, murder
怨|grudge, show resentment, be jealous
串|shish kebab, spit, skewer
腫|tumor, swelling
餅|mochi rice cake
箸|chopsticks
斑|spot, blemish, speck, patches
摯|gift, seriousness
堆|piled high
芯|wick
蜜|honey, nectar, molasses
股|thigh, crotch, yarn, strand
匂|fragrant, stink, glow, insinuate, (kokuji)
玩|play, take pleasure in, trifle with, make sport of
蜂|bee, wasp, hornet
椅|chair
叱|scold, reprove
挨|push open
餌|food, bait, prey, tempting profit
脊|stature, height
凄|uncanny, weird, threatening, horrible
嫉|jealous, envy
膝|knee, lap
恣|selfish, arbitrary
麺|noodles, wheat flour
戴|be crowned with, live under (a ruler), receive
裾|cuff, hem, foot of mountain
冥|dark
麓|foot of a mountain
稽|think, consider, quarrel
蹴|kick
訃|obituary
剥|come off, peel, fade, discolor
蓋|cover, lid, flap
畏|fear, majestic, graciously, be apprehensive
喉|throat, voice
拭|wipe, mop, swab
頬|cheek
貼|stick, paste, apply
諦|abandon, give up
煎|broil, parch, roast, boil
緻|fine (i.e. not coarse)
哺|nurse, suckle
罵|abuse, insult
乞|beg, invite, ask
嗅|smell, sniff, scent
蔑|ignore, despise, neglect, ridicule
宛|address, just like, fortunately
萎|wither, droop, lame
咽|choked, smothered, stuffy
淫|lewdness, licentiousness
臆|timidity, heart, mind, fear, cowardly
苛|torment, scold, chastise
崖|cliff, bluff, precipice
骸|bone, body, corpse
顎|jaw, chin, gill
僅|a wee bit
巾|towel, hanging scroll, width
窟|cavern
詣|visit a temple
隙|crevice, fissure, discord, opportunity, leisure, also N5013
桁|beam, girder, spar, unit or column (accounting)
舷|gunwale
勾|be bent, slope, capture
梗|for the most part, close up
塞|close, shut, cover, block, obstruct
柵|stockade, fence, wier, entwine around
拶|be imminent
醒|awake, be disillusioned, sober up
戚|grieve
羨|envious, be jealous, covet
腺|gland
詮|discussion, methods called for, selection, result
遡|go upstream, retrace the past
痩|get thin
遜|humble, modest
唾|saliva, sputum
綻|be rent, ripped, unravel, run, begin to open, smile
酎|sake
捗|make progress
潰|crush, smash, break, dissipate
溺|drown, indulge
填|fill in
妬|jealous, envy
頓|suddenly, immediately, in a hurry
捻|twirl, twist, play with
氾|spread out, wide
肘|elbow, arm
蔽|cover, shade, mantle, capsize, be ruined
貌|form, appearance, countenance
勃|suddenness, rise
昧|dark, foolish
沃|fertility
侶|companion, follower
賂|bribe
弄|play with, tamper, trifle with
傲|be proud
刹|temple
喩|to compare; to liken; to speak figuratively; to illustrate; to use a simile
嘲|ridicule, insult
毀|break, destroy, censure, be chipped, be scratched, be broken, be ruined
彙|same kind
慄|fear
憬|yearn for, aspire to, admire
拉|Latin, kidnap, crush
曖|dark, not clear
楷|square character style, correctness
鬱|gloom, depression, melancholy
璧|sphere, ball
瘍|boil, carbuncle
箋|paper, label, letter, composition
籠|basket, devote onself, seclude oneself, cage, coop, implied
羞|feel ashamed
諧|harmony
貪|covet, indulge in
踪|remains, clue, footprint
辣|bitter
錮|to tie
丑|
丞|help
乃|from, possessive particle, whereupon, accordingly
之|of, this
乎|
乘|
也|to be (classical)
云|say
亘|
亙|range, reach, extend, cover
些|a little bit, sometimes
亞|
亥|
亦|
亨|undergo, answer (phone), take, get, catch
亮|clear, help
仔|offspring
伊|Italy, that one
伍|5, 5-man squad, file, line
伶|
伽|nursing, attending, entertainer
佃|cultivated rice field
佑|help, assist
佛|France
侃|strong, just, righteous, peace-loving
來|come, due, next, cause, become
侑|urge to eat
俄|sudden, abrupt, improvised
俐|
俠|
俣|crotch, thigh, groin, (kokuji)
俱|
倖|happiness, luck
倦|
倭|
偲|recollect, remember
傭|employ, hire
傳|
僞|
價|
儉|
儲|be profitable, yield profit
允|license, sincerity, permit
兎|rabbit, hare
兒|child, young of animals
兜|helmet, head piece
其|that
冨|enrich, wealthy, abundant
冴|be clear, serene, cold, skilful
凉|nice and cool
凌|endure, keep (rain)out, stave off, tide over, defy, slight, surpass
凛|cold
凜|
凧|kite, (kokuji)
凪|
凰|female phoenix bird
凱|victory song
函|box (archaic)
剩|
劉|axe, kill
劍|
劫|threat, long ages
勁|strong
勳|
勺|
勿|not, must not, do not, be not
匁|
匡|correct, save, assist
卜|divining, fortune telling
卯|sign of the hare, 5-7AM, 4th zodiac sign, rabbit, east
卷|
卽|
卿|you, lord, secretary, state minister
厨|kitchen
厩|barn, stable
叉|fork of road, crotch
叡|intelligence, imperial
叢|
只|only, free, in addition
叶|grant, answer
吞|
吻|
吾|I, my, our, one's own
哉|how, what, alas, "?" (question mark)
哨|scout, sentinel
哩|
啄|peck, pick up
喋|
喧|noisy, boisterous
喬|high, boasting
單|
喰|eat, drink, receive (a blow), (kokuji)
嘉|applaud, praise, esteem
嘗|once, before, formerly, ever, never, ex-, lick, lap up, burn up, taste, udergo, underrate, despise
嘩|noisy
噂|rumor, gossip, hearsay
噌|throat
嚴|
圃|
圈|
國|country
圓|yen, circle, round
團|association
圭|square jewel, corner, angle, edge
坐|sit
坦|level, wide
埜|
埴|clay
堯|high, far
堰|dam, prevent, stop up
堵|fence, railing, enclosure
堺|world
塙|projecting tableland or mountain
增|
壕|trench, dugout, air raid shelter
壘|
壞|
壬|
壯|
壽|longevity, congratulations
夷|barbarian, savage, Ainu
奄|cover
奎|star, god of literature
套|hackneyed
奧|
奬|
姥|old woman
姪|niece
娃|
娩|bear (children)
嬉|glad, pleased, rejoice
孃|
孜|
孟|chief, beginning
宋|dwell, Sung dynasty
宏|wide, large
宕|cave
宥|soothe, calm, pacify
寅|sign of the tiger, 3-5AM, 3rd zodiac sign
寓|temporary abode, keep, imply, suggest
寢|
實|truth, reality
寬|
寵|
將|
專|
尖|be pointed, sharp, taper, displeased, angry, edgy
尤|
尭|
屑|
峨|high mountain
峯|peak, summit
峻|high, steep
峽|
崚|
嵩|be aggravated, grow worse, grow bulky, swell
嵯|steep, craggy, rugged
嶋|island
嶺|peak, summit
巌|rock, crag, boulder
巖|rock, crag, boulder
巢|
已|stop, halt, previously, already, long ago
巳|sign of the snake, 9-11AM, 6th zodiac sign, serpent
巴|comma-design
巷|fork in road, scene, arena, theater
巽|southeast
帖|quire (of paper), bundle of seaweed, counter for screens, notebook
帶|
幌|canopy, awning, hood, curtain
幡|flag
庄|level
庇|protect, shield, defend, eaves, canopy, penthouse, visor
庚|7th, 7th calendar sign
庵|hermitage, retreat
廟|mausoleum, shrine, palace
廣|broad, wide, spacious
廳|
廻|round, game, revolve, go around, circumference
廿|twenty, 20
弘|vast, broad, wide
弛|slacken, relax
彈|
彌|
彗|comet
彦|lad, boy (ancient)
彪|
彬|refined, gentle
從|
徠|
徵|
德|
徽|good, beautiful, badge
忽|in a moment, instantly, all of a sudden, neglect, disregard
怜|wise
恆|
恕|excuse, tolerate, forgive
恢|wide, large, enlarge
恰|just as, as though, fortunately
悉|
悌|
惇|sincere, kind, considerate
惚|fall in love with, admire, grow senile
惟|consider, reflect, think
惠|blessing, grace, favor, kindness
惡|
惣|all
惹|attract, captivate
惺|
愼|
慧|wise
憐|pity, have mercy, sympathise, compassion
應|answer, yes, OK, reply, accept
懷|
戊|5th calendar sign
或|some, one, or, possibly, a certain
戟|
戰|
戲|
托|
拂|
拔|
拜|
按|
挺|counter for guns, inksticks, palanquins, rickshaws, bravely volunteer
挽|saw, turn (lathe), grind
捧|lift up, give, offer, consecrate, sacrifice, dedicate
捲|
捷|victory, fast
捺|press, print, affix a seal, stamp
掠|
掬|
揃|be complete, uniform, all present
揭|
搖|
搜|
摑|
摺|rub, fold, print (on cloth)
撒|scatter, sprinkle, give them the slip
撞|
撫|stroke, pat, smooth down
播|plant, sow
撰|composing, editing, compiling, selecting
擊|
擢|excel in, surpass, pull out, select
攝|
收|income
敍|
敦|industry, kindliness
斐|beautiful, patterned
斡|go around, rule, administer
斧|ax, hatchet
斯|this, thus, such, verbal pause
於|at, in, on, as for
旭|rising sun, morning sun
昂|
昊|sky, big
昌|prosperous, bright, clear
昏|dark, evening, dusk
昴|
晃|clear
晄|clear
晋|advance
晏|
晒|
晚|
晝|
晟|
晦|dark, disappear
晨|
智|wisdom, intellect, reason
暉|shine, light
暢|stretch
曆|
曉|
曙|dawn, daybreak
曝|bleach, refine, expose, air
曳|pull, tug, jerk, admit, install, quote, refer to
曾|formerly, once, before, ever, never, ex-
朋|companion, friend
朔|conjunction (astronomy), first day of month
李|plum
杏|apricot
杖|staff, cane
杜|woods, grove
杭|stake, post, picket
杵|wooden pestle
杷|kind of rake
枇|spoon
柊|holly
柏|oak
柑|citrus, orange
柘|wild mulberry
柚|citron
柴|brush, firewood
柾|straight grain, spindle tree, (kokuji)
栖|nest, rookery, hive, cobweb, den
栗|chestnut
栞|
桂|Japanese Judas-tree, cinnamon tree
桐|paulownia
桔|used in plant names
桧|Japanese cypress
桶|tub, bucket
梁|weir, fish trap, beam, girder
梓|catalpa tree
梛|
條|article, ray of light
梢|treetops, twig
梧|
梯|ladder, stairs, insatiable drinking
梶|sculling oar
棲|live, dwell
椀|wooden or lacquered bowl
椋|type of deciduous tree, grey starling
椛|
椰|coconut tree
椿|camellia
楊|willow
楓|maple
楕|ellipse
楚|whip, cane
楠|camphor tree
楢|oak
楯|
榊|sacred Shinto tree, (kokuji)
榎|lotus tree
榛|hazelnut, filbert
榮|flourish, prosperity, honour, glory, splendour
槇|twig, Chinese black pine
槌|hammer, mallet
槍|spear, lance, javelin
槙|twig, ornamental evergreen
槻|Zelkova tree
樂|music, comfort
樋|water pipe, gutter, downspout, conduit
樟|camphor
樣|
樫|evergreen oak, (kokuji)
樺|birch
樽|barrel, cask, keg
橘|mandarin orange
橙|
橫|
檀|cedar, sandlewood, spindle tree
檎|pear, apple
檜|Japanese cypress
檢|
櫂|
櫓|oar, tower
櫛|comb
櫻|cherry
欣|take pleasure in, rejoice
欽|respect, revere, long for
歎|
此|this, current, next, coming, last, past
步|
歷|
殆|almost, quite, really
毅|strong
每|
毘|help, assist
毬|burr, ball
氣|spirit, mind
汀|water's edge, shore, bank
汐|eventide, tide, salt water, opportunity
汝|you, thou
汲|draw (water), ladle, scoop, pump
沌|primeval chaos
沓|
沫|
洛|Kyoto, the capital
洲|continent, sandbar, island, country
洵|
洸|sparkling water
浩|wide expanse, abundance, vigorous
浬|
涉|
淀|pool, eddy
淋|lonely, deserted
淚|
淨|
淳|pure
淵|abyss, edge, deep pool, the depths
渚|strand, beach, shore
渥|kindness
渴|
湊|port, harbor
湘|name of Chinese river, the Sagami river
湛|fill, wear (a smile)
溜|collect, gather, be in arrears
溢|overflow, inundate, spill
溫|
滉|
滯|
漕|rowing, skull, paddle
漣|
漱|gargle, rinse mouth
澁|
澪|
濕|
濡|get wet, damp, make love
瀕|shore, brink, verge
瀧|waterfall, rapids, cascade
瀨|
灘|open sea
灸|moxa cautery, chastisement
灼|miraculous
烏|crow, raven
焚|burn, kindle, build a fire, boil, cook
焰|
煉|refine metals, kneading over fire
煌|
煤|
熙|bright, sunny, prosperous, merry
燈|nonstandard for J825
燎|
燒|
燕|swallow (bird)
燦|brilliant
燭|light, candlepower
燿|
爭|
爲|
爾|you, thou, second person
牒|
牟|pupil (eye), moo (cow sound)
牡|male
牽|pull, tug, jerk, admit, install, quote, refer to
犀|
狀|
狹|
狼|wolf
猪|boar
獅|lion
獸|
玖|beautiful black jewel, nine
玲|sound of jewels
珀|amber
珂|jewel
珈|ornamental hairpin
珊|
琉|lapis lazuli
琢|polish
琥|jewelled utensil
琳|
琵|glissando on strings, lute
琶|lute
瑚|
瑛|sparkle of jewelry, crystal
瑞|congratulations
瑳|
瑶|
瓜|melon
瓢|gourd
甥|nephew
甫|
畠|field, farm, garden, (kokuji)
畢|
疊|
疋|head, no. of animals
疏|
瘦|
皐|swamp, shore
皓|white, clear
盃|
盜|
盡|
眞|truth, reality, Buddhist sect
眸|
瞥|glance at
矩|
砥|whetstone, grindstone
砦|fort, stronghold, entrenchments
砧|
硯|
碎|
碓|
碗|porcelain bowl, tea cup
碧|blue, green
碩|large, great, eminent
磐|rock, crag, cliff, wall (in a mine)
磯|seashore, beach
祁|
祇|national or local god, peaceful, great
祐|help
祕|
祢|ancestral shrine
祷|pray
祿|
禄|fief, allowance, pension, grant, happiness
禎|happiness
禪|
禮|
禰|ancestral shrine
禱|
禽|bird, captive, capture
禾|2 branch tree
秤|balances, scales, steelyard
秦|Manchu dynasty, name given to naturalized gaijin
稀|rare, phenomenal, dilute (acid)
稔|harvest, ripen
稜|angle, edge, corner, power, majesty
稟|
稻|
穗|
穣|good crops, prosperity
穰|
穹|
穿|put on (to the feet), dig, pierce, drill
窄|narrow, fold, furl, shrug, pucker, shut, close
窪|depression, cave in, sink, become hollow
窺|lie in wait, spy on, reconnoiter
竣|end, finish
竪|length, height, warp
竺|
竿|pole, rod, scale beam, violin neck
笈|
笙|
笠|bamboo hat, one's influence
笹|bamboo grass
筈|notch of an arrow, ought, must, should be, expected
筑|an ancient musical instrument
箔|foil, gilt
箕|winnowing
篇|volume, chapter, book, editing, compilation
篠|also N3428, bamboo grass
簞|
簾|bamboo screen, rattan blind
籾|
粟|millet
粥|rice gruel
粹|
糊|paste, glue, sizing
紐|string, cord, braid, lace, tape, strap, ribbon
紗|gauze, gossamer
紘|large
紬|pongee (a knotted silk cloth)
絃|string, cord, samisen music
絆|bonds, fetters
絢|kimono design
綜|rule
綠|
綴|compose, spell, write, bind (books)
綸|thread, silk cloth
綺|figured cloth, beautiful
綾|design, figured cloth, twill
緋|scarlet, cardinal
緖|
緣|
縞|stripe
縣|
縱|
繡|
繫|
纂|
纏|wear, wrap, tie, follow around, collect
纖|
羚|
翔|soar, fly
翠|
耀|shine, sparkle, gleam, twinkle
而|rake
耶|question mark
耽|
聡|wise, fast learner
聽|
肇|beginning
肋|
肴|accompaniment for drinks
胡|barbarian, foreign
胤|
脩|dried meat
脹|
腔|body cavity
膏|
臟|
臥|bend down, bow, lie prostrate
與|participate in, give, award, impart, provide, cause
舜|type of morning glory, rose of Sharon, althea
舵|rudder, helm, wheel
芙|lotus, Mt Fuji
芥|mustard, rape, dust, trash, rubbish
芦|reed, rush
芭|banana
芹|parsley
苑|garden, farm, park
苔|moss, lichen
苺|strawberry
茄|eggplant
茅|miscanthus reed
茉|jasmine
茜|madder, red dye, Turkey red
茸|mushroom
荻|reed
莉|jasmine
莊|
莞|
莫|must not, do not, be not
菅|sedge
菖|iris
菩|kind of grass, sacred tree
菫|
菱|diamond, water chestnut
萄|grape vine, wild grape
萊|
萌|show symptoms of, sprout, bud, malt
萠|
萩|bush clover
萬|10000
萱|
葡|wild grape, Portugal
董|correct
葦|reed, bullrush
葵|hollyhock
葺|thatch, cover, shingle, tile
蒐|gather
蒔|sow (seeds)
蒙|ignorance, darkness, get, receive, be subjected to, sustain, Mongolia
蒲|bullrush, flag, cattail
蒼|blue, pale
蓉|lotus
蓑|
蓬|sagebrush, wormwood, mugwort
蓮|lotus
蔓|vine, tendril, influence, connections, good offices, spread, sprawl, thrive, rampant, powerful
蔣|
蔦|vine, ivy
蔭|shade, shadow, backing assistance
蕃|
蕉|banana
蕎|buckwheat
蕗|butterbur, bog rhubarb
蕨|bracken, fernbrake
蕪|turnip
蕾|bud (plants, mushrooms not yet opened)
薗|garden, yard, farm
薙|mow down (the enemy)
薩|Buddha
薰|
藁|
藏|hide, own, have, possess
藝|art, craft, performance, acting, trick, stunt
藥|
蘇|be resuscitated, revived
蘭|orchid, Holland
虛|
蝦|shrimp, prawn, lobster
蝶|butterfly
螺|a small, edible, helical fresh water mollusk
蟬|
蟹|crab
蠟|
衞|
衿|
袈|a coarse camlet
袴|men's formal divided skirt
裝|
裟|Buddhist surplice
裡|reverse, inside, palm, sole, rear, lining, wrong side
裳|skirt
襖|opaque sliding door
覽|
訊|request, question, investigate
訣|separation, part, secret
註|
詢|consult with
詫|deceive, delude, apologize
誼|
諄|
諏|consult
諒|fact, reality, understand, appreciate
諺|proverb
謂|reason, origin, history, oral tradition
謠|
讃|praise, title on a picture
讓|
豹|leopard, panther
貰|get, have, obtain
賑|flourish, be bustling, prosperity
賣|
賴|
赳|strong and brave
跨|
蹄|hoof
蹟|remains, traces, footprint
輔|help
輯|
輿|palanquin, bier
轉|
轟|
辰|sign of the dragon, 7-9AM, 5th zodiac sign
辻|crossing, crossroad, street corners, (kokuji)
辿|follow (rod), pursue
迂|roundabout way
迄|
迦|(used phonetically)
迪|edify, way, path
逗|stop
這|crawl, creep, grovel, trail (vines)
逞|
逢|meeting, tryst, date, rendezvous
遁|flee, escape, shirk, evade, set free
遙|far off, distant, long ago
遥|far off, distant, long ago
遼|distant
邑|village, rural community, right-side B rad
郁|cultural progress, perfume
郞|
鄭|an ancient Chinese province
酉|sign of the bird, west (sake rad)
醇|pure sake', purity, affection
醉|
醍|whey, good Buddhist teaching
醐|boiled butter
醬|
釀|
釉|glaze, enamel
釘|nail, tack, peg
釧|bracelet
銑|
鋒|dagger, sword's point, festival car, float
鋸|saw (cuts wood)
錄|
錆|tarnish
錐|
錘|
錫|copper, tin
鍊|
鍬|hoe with long blade at acute angle
鎧|put on armor, arm oneself
鎭|
鑄|
閃|
閏|
閤|small side gate
阿|Africa, flatter, fawn upon, corner, nook, recess
陀|steep
陷|
隈|corner, nook, recess
險|
隼|falcon
雀|sparrow
雁|wild goose
雛|chick, squab, duckling, doll
雜|
雫|drop, trickle, dripping
霞|be hazy, grow dim, blurred
靖|peaceful
靜|
鞄|suitcase, bag, briefcase
鞍|saddle
鞘|sheath, case, margin, difference, shells (of beans)
鞠|
鞭|whip, rod
頁|page, leaf
頌|
頗|prejudiced, exceedingly
顚|
顯|
颯|suddenly, smoothly
飜|
饗|banquet
馨|fragrant, balmy, favourable
馳|run, gallop, sail, drive (a wagon), win (fame), dispatch
馴|get used to, experienced, tamed
駈|run, gallop, advance
駕|vehicle, palanquin, litter, hitch up an animal
駿|a good horse, speed, a fast person
騷|
驍|
驗|
髮|
魁|charging ahead of others
魯|foolish, Russia
鮎|freshwater trout, smelt
鯉|carp
鯛|sea bream, red snapper
鰯|sardine, (kokuji)
鱒|salmon trout
鱗|
鳩|pigeon, dove
鳳|male mythical bird
鳶|
鴨|wild duck, easy mark
鴻|large bird, wild goose
鵜|cormorant
鵬|phoenix
鷄|
鷗|
鷲|eagle
鷹|hawk
鷺|heron
麒|
麟|
麿|I, you, (kokuji)
黃|
黎|dark, black, many
黑|
默|
黛|blackened eyebrows
鼎|three legged kettle
齊|alike, equal, similar, Saito
龍|dragon, imperial
欄|
廊|
朗|
虜|
類|
猪|
神|
祥|
福|
諸|
渚|
琢|
祐|
禎|
悔|
侮|
僧|
勉|
勤|
卑|
嘆|
器|
墨|
層|
憎|
懲|
敏|
暑|
梅|
海|
漢|
煮|
碑|
社|
祉|
祈|
祖|
祝|
禍|
穀|
突|
節|
練|
繁|
署|
者|
臭|
著|
視|
謁|
謹|
賓|
贈|
逸|
都|
難|
響|
煕|shine
渕|edge
盧|hut
趙|nimble, late-going
嶌|island
倶|both
呆|be amazed, disgusted, shocked
粕|scrap, waste
姜|Chinese surname, ginger
崔|cliff, bluff, precipice
聯|party, gang, clique
麹|malt, yeast
炒|broil, parch, roast, fry
屏|wall, fence
苫|rush matting
姑|mother-in-law
僑|temporary home
魏|high, large
荏|bean
銚|sake bottle
薮|thicket, bush, underbrush, grove
鴈|wild goose
翫|
嶽|peak
焉|how, why, then
苅|cutting (grass)
尹|an official rank
狐|fox
鴎|seagull
瀋|juice, broth
狛|archaic part of Korea, lion-dog shrine guards
壷|
橿|oak
煥|
癌|cancer, cancerous evil
嘘|lie, falsehood
旛|
篭|seclude oneself, cage, coop, implied
娼|prostitute
篆|seal-style characters
鮫|
牌|label, signboard, medal, mahjong tiles
蒋|reed
襄|
蛋|barbarian, egg
笘|
宍|muscles, meat
囃|play (music), accompany, beat time, banter, jeer, applaud
簗|
峙|tower, soar
舘|mansion, large building, palace
銕|
鄒|place name
蜷|an edible river snail
箏|a koto
鵠|swan
諌|admonish, dissuade
牝|female
笏|
噺|talk, (kokuji)
抒|
叩|strike, beat, hit, thrash, criticize
蔡|
鍾|spindle, gather, collect
仇|foe, enemy, revenge, grudge, feud
瞑|sleep, dark, close eyes
鍼|needle
礒|rock, beach, shore
咸|all, same
歪|warp, bend, strained, distort
韮|leek
薔|a kind of grass
膠|glue, isinglass
呑|drink
茗|tea
瘤|lump, swelling
澤|swamp
溥|
厦|
冤|false charge, hatred
侠|tomboy, chivalry
贅|luxury
汪|
猷|
曼|
撚|twist, twine, kinky
噛|chew, bite, gnaw
桝|
闊|wide
浙|name of a Chinese river
彭|swelling, sound of drum
淘|select
剃|shave
徘|wonder
袁|
舩|
簑|
甦|be resuscitated, revived
檄|written appeal, manifesto
姚|beautiful
蛭|leech
椙|Japanese cedar, cryptomeria
贋|counterfeit, forgery
洒|wash, sprinkle
諜|
蓼|luxurious grass, a smartweed
甕|jar, jug, vat
喘|pant, gasp, breathe hard
鉾|halberd, arms, festival float
嗜|like, taste, modest
偕|together
頚|neck, head
胚|embryo
牢|prison, jail, hardness
糞|shit, feces, excrement
吊|suspend, hang, wear (sword)
鮭|salmon
轍|rut, wheel track
醤|a kind of miso
舛|dancing radical
謳|extol, declare, express
杞|river willow
狸|tanuki, raccoon
什|
仄|be seen dimly, suggest, intimate, faint, stupid, hint
佼|
侭|
倅|
做|
僻|prejudice, bias, rural area
兇|wickedness
凋|wither, droop, lame
剪|
匕|
匙|
厖|
厭|get tired of, satiate, bore
叛|isobey, defy, go back on, rebel, rebellion
吃|stammer
吋|
吠|bark, howl, cry
呎|
咎|
咳|cough, clear throat
唖|
嘔|
噸|
嚢|pouch, purse, bag
囁|
坤|divination sign, land, earth
垢|dirt, grime, earwax
埠|wharf
塡|fill in, fill up, make good
塵|dust, trash, garbage
夙|
夥|
妓|stretch, singing girl, geisha, prostitute
妾|
姐|elder sister, maidservant
姦|wicked, mischief, seduce, rape, noisy
婉|
婢|
嬌|attractive
嬬|mistress, weak
嬰|
孕|become pregnant
屁|
屍|
屠|slaughter, butcher, slay
屡|
嵌|go into, plunge, inlay
巫|
幟|flag, banner, streamer
庖|
廓|
彊|strong
怯|cowardice, wince, flinch, hesitate, waver
悛|
悶|be in agony, worry
愈|
慾|
憑|possess, haunt
懺|
截|
扮|impersonate, dress up, disguise, thin shingles
抉|gouge, hollow out, bore, pry
捌|
掟|law, commandments, regulations
掩|
掴|catch, seize, grasp, hold, arrest, capture
掻|scratch, rake, comb, paddle, behead
揖|bow with arms folded, come together, assemble
撹|
擾|
旱|
暈|
暝|
曰|say, reason, pretext, history, past
杓|
栂|hemlock, (kokuji)
梟|
梱|pack, tie up, bale
梵|Sanskrit, purity, Buddhist
棉|
棘|thorn, splinter, spine, biting words, briers
槃|
樒|
樗|
樵|
橇|
欝|
沐|wash
泪|
洩|leak, escape
涅|
涜|defile, blaspheme, ditch
渾|all, turbidity
溌|sprinkle, lively, vigorous
滲|imbued with
漉|manufacture paper, spread out thin, strain, percolate
潅|
澱|sediment, grounds, dregs, stagnant
濠|moat, ditch, canal, Australia
濾|
瀞|pure water, clear water, pool in a river
炬|torch, signal fire
烙|
烹|boil, cook
焔|
煽|fan, flap, instigate, agitate, bolster up, gulp down
熔|
燐|phosphorus
爺|old man, grampa
狒|
狗|puppy, dog
狡|
狽|
猥|obscene
猾|
珪|
琲|string of many pearls
畦|
畷|rice field ridge path
疹|measles, sickness
痒|itchy
痔|
痰|
痺|
眩|
睾|testicles
砺|whetstone, polish
碇|
碍|
祀|enshrine, worship
祓|
祟|curse, haunt
禦|
禿|
稗|humble, deccan grass
穆|
穎|
竃|
站|
笥|lunch box, clothes chest
筏|raft
箆|
箪|bamboo rice basket
箭|arrow
簸|winnow, fan
籤|
粁|
粍|
糎|
糟|
糠|rice bran
絨|
綬|ribbon
繋|tie, fasten, chain, tether, connect
繍|sew, figured cloth
罫|ruled line
翰|
聘|invite
聚|
聾|
肛|anus
肱|
胱|bladder
脆|brittle, fragile, easy to beat, sentimental, susceptible
脛|
腑|viscera, bowels
膿|
舅|father-in-law
艘|counter for ships
芻|grass cutting, hay
苓|
莨|
菰|reed used for matting
葱|stone leek, Welsh onion
蒜|garlic
蔚|
蕊|
蕩|
薯|
藷|
虔|respect
蚤|flea
蛎|oyster
蛙|frog
蛤|
蛸|
蛾|
蝉|cicada
蝋|
蝕|eclipse, occultation, be defective
蝿|
蟄|hibernation of insects
蟻|ant
袷|
覗|peep, peek, come in sight
詑|
誹|ridicule, slander
謬|
譬|
讐|enemy, revenge
賎|
赫|suddenly
趨|run, go, quick, tend towards
跪|
躇|hesitate
躊|hesitate
躓|stumble
躯|
躾|
輻|
轡|
逼|urge, force, imminent, spur on
邁|
酋|
釦|
鉦|bell, gong, chimes
鋏|
鋤|
鋪|
鋲|
錨|
鎚|
鏑|arrowhead
鑓|
鑿|chisel
雉|
靭|soft, pliable, quiver
頰|cheeks, jaw
顛|overturn, summit, origin
飴|rice jelly, candy
餐|
饅|bean-jam dumpling, manjuu
駁|refutation, contradiction
騙|deceive
騨|dappled grey horse
驢|
髭|beard, mustache
鮒|
鮨|
鮪|tuna
鯖|mackerel
鯵|horse mackerel
鰍|bullhead
鰐|
鰭|
鰹|bonito
鰻|eel
鱈|codfish, (kokuji)
鴬|
鵡|cockatoo
鸚|parrot, parakeet
鹵|
鹸|saltiness
黍|
鼈|snapping turtle
鼠|
鼾|
剝|
𠮟|
咋|shout, chew, eat
證|
潘|water in which rice has been washed
栩|type of oak
覃|extend, deep, large
疵|crack, flaw, scratch, speck
藪|thicket, bush, underbrush, grove
濱|
叟|old person
濤|waves, billows
剱|sword
鏝|soldering iron, trowel, curling iron, flat iron
鰒|abalone
熾|kindling fire
熨|flatiron, smooth out
蔟|gather together
縷|thread
圀|country
蹊|path
罠|trap, snare
譚|talk
涛|waves, billows
毫|fine hair, brush, not at all
隕|fall
邊|
腱|tendon
爛|be sore, inflamed, bleary, fester
扁|level, small
愕|surprised, frightened
怡|rejoice, enjoy
彷|stray, wander, loiter
俑|effigy
鐸|large hand bell
鉉|handle
諫|admonish, dissuade
蜃|clam
瞰|look, see
炸|frying, explosion
涌|boil, ferment, seethe, uproar, breed
泄|leak
麩|light wheat-gluten bread
鑼|gong
轢|run over
諤|speaking the truth
褪|fade, discolour
蛯|shrimp
紆|crouch
糀|malt
磋|polish
獏|tapir
爬|scratch
澂|
櫃|chest, coffer, tub
曄|shine, flourishing
彿|dimly
齋|Buddhist food, room, religious purification, worship, avoid, alike
飫|satiety
頸|neck, head
軋|squeak, creak, grate
詭|lie, deceive
稷|millet
瀾|large waves
滔|overflowing
榜|rudder, oar, name plate
桓|marking post
曠|wide, worthless
揉|rub, massage, shampoo, debate vigorously, train, coach, worry, get in trouble
徊|wandering
媚|flatter, humor, flirt
壺|jar, pot
嗚|weep, ah, alas
頷|nod approval
鑚|make fire by rubbing sticks
酩|sweet sake
酊|intoxication
螢|firefly
薇|an edible fern
臍|navel
羹|hot soup
箙|quiver
窈|quiet
祠|small shrine
痍|injury
甑|rice-steaming pot
瑪|agate, onyx
瑙|agate, onyx
熏|
澹|frankly, simply
櫨|wax tree
桿|shield, pole
柩|bier, coffin
捏|knead, mix
忖|conjecture
幇|help
嵜|steep, promontory
墟|ruins
啼|bark, chirp, cry
咤|clicking (with tongue)
咄|pshaw, god forbid
劭|recommend, work hard, beautiful
佗|proud, lonely
饒|abundant
餡|bean jam
餞|farewell gift
霍|quick, sudden
雖|although, however
隋|name of a Chinese dynasty
陜|narrow
鉗|shut up
鈞|equal, important point
邱|hill
躬|body, self
誦|recite, chant
衾|quilt, bedding
蠣|oyster
蜻|dragonfly
蜘|spider
蛛|spider
蛉|dragonfly, moon moth
虻|gadfly, horsefly
蘊|pile up
苧|hemp, flax
臺|stand, counter for vehicles
腿|thigh, femur
翳|hold aloft
翅|(insect) wings, fly, merely
纓|crown string, breast harness
筬|reed, guide for yarn on a loom
禹|name of a Chinese emperor
礫|small stones
矮|low, short
瞽|blind person
瞞|deception
癬|ringworm
瑕|flaw, blemish
焙|fire, roast
瀝|dropping
瀚|wide & large
瀑|waterfall
澎|turbulent water
滸|vicinity
溟|dark, ocean
湃|sound of waves
涵|immerse
殷|flourishing
欅|keyaki, zelkova tree
槐|type of Japanese pagoda tree
梠|a kind of quince
斂|tighten, stiffen
攫|abduct
攘|chase away, steal
揶|tease, play with
揄|pull, tease, play with
拮|be imminent
拗|crooked, twisted, distorted, perverted, cross
戌|7-9PM, 11th zodiac sign, dog
恪|carefulness
恍|unclear, senile, stupid, joke
徨|wandering
帚|broom
巍|high
寨|fort
娟|beauty of face
址|ruins
嗤|laugh, ridicule
嗟|be satisfied, grieve, ah
唸|groan, roar
剌|opposed, biased
几|table, table enclosure
凖|correspond to, proportionate to, conform, imitate
冽|cold
冑|lineage, helmet
佞|flattery, insincerity
鶯|nightingale
鴉|crow, raven
鱸|sea bass
鰤|yellowtail
鰓|gills, gill slits
鰊|herring
鰈|sole, flatfish, flounder
鮓|sushi, seasoned rice
鬆|loose, dishevelled, pore, cavity in overboiled daikon
髷|topknot
髑|skull
髏|skull
驟|run, suddenly
饌|food, offering
饉|hunger
餃|gyoza
飄|turn over, wave
顰|scowl, raise eyebrows
顆|grain (e.g. rice)
韶|music, spring
韋|tanned leather
韃|proper name
靼|smooth
靱|soft, pliable, quiver
雍|softening, mitigation
隘|narrow, obstruct
陞|go up, climb
陋|narrowness, meanness, humbleness
閔|grieve, be sad, pity
鐙|stirrup
鐔|sword guard, hilt
鐐|hatchet, vanadium
鎗|spear, lance, javelin
鎔|fuse, melt
鈿|ornamental hairpiece
醂|remove astringency, bleach in water
鄲|place name
邯|place name, tree cricket
邉|
邇|approach, near, close
邂|meet unexpectedly
逡|saunter, go back
逅|meet
輦|palanquin
軛|yoke
躙|edge forward, trample
蹂|step on
跏|sitting in the lotus position
趾|footprint, remains
贔|strength, power
贄|offering, sacrifice
谿|valley
讀|
謐|quiet
諍|quarrel
詈|ridicule
訝|doubt
訛|accent, dialect
襷|cord to hold up sleeves, (kokuji)
裔|descendant, border
袰|hood, top, awning, cover
衒|show off, display, pretend
蠍|scorpion
蟋|cricket, grasshopper
蟀|cricket, grasshopper
號|
蘆|reed, rush
葯|pollen pod at tip of stamen, type of tall grass
葭|reed
莱|goosefoot, pigweed
莪|type of thistle
莚|straw mat
茹|boil, seethe
茵|cushion, mattress
茲|here
茫|wide, extensive
芒|pampas grass, beard (grain)
艸|grass radical
舳|bow, prow
舫|moor, berth
膵|pancreas
膣|vagina
膀|bladder
腟|vagina
腓|calf (of leg)
聰|wise, fast learner
翹|excellence
罹|catch, get
繹|pull out
繪|picture, drawing, painting, sketch
繩|rope, cord
繚|put on, twist around
緘|shut, seal
綏|peaceful, cheap, grab strap
粂|used in proper names
籐|rattan, cane
籃|basket
簒|rob
簀|rough mat (reeds)
箴|warning, counsel, presept, needle
箟|
箒|broom
筧|waterpipe, flume
稠|density
祗|respectful
碆|arrowhead, weight attached to an arrow by a cord
砿|ore
矜|pride, respect
矗|luxuriance
瞼|eyelids
睨|glaring at, authority, power, scowl at
癈|chronic illness, getting crippled
瘡|wound, boil, syphilis
痙|have a cramp
疽|carbuncle
疸|jaundice
疱|smallpox, blister
疆|boundary
甞|lick, lap up, burn up, taste, udergo, underrate, despise
瓷|high quality porcelain
瑣|small, chain
珎|
獰|bad
猊|lion, the seat of a famous priest
牀|
燼|embers
燻|smoulder, fume, oxidize
燵|foot warmer, (kokuji)
燗|warming sake
瀟|pure, clean
瀉|evacuation
濬|deep, dredge
漲|overflow
滓|dregs, grounds
滄|ocean
溪|valley
游|float, swim
渠|ditch, canal, lock
淺|
淇|name of a Chinese river
涸|dry up, mature
涎|saliva, slobber
洙|name of a Chinese river
泗|name of a Chinese river, snivel
泓|deep clear water
沁|penetrate, soak in
檻|pen, corral, cell, jail
樸|bark of a tree
樓|tower, turret
槿|rose of Sharon
榧|Japanese nutmeg, plum-yew
楡|elm
椒|mountain ash
棹|pole a boat
棣|flowering almond
棗|jujube
栫|weir
栢|oak
杳|darkness, dimly
朧|haziness, dreaminess, gloom
會|meet, party, association, interview, join
曵|
斌|beautiful, harmony of appearance
敲|strike, beat, hit
摸|search, imitate, copy
拇|thumb
戮|kill
戎|warrior, arms, barbarian, Ainu
戀|in love, yearn for, miss, darling
憚|hesitate, shrink, awe
憔|get thin
愾|anger, breathlessness
惻|be sad
悸|pulsate, shudder
悴|becoming emaciated, son
恂|sincere, fear, sudden, blinking
弩|bow (arrow)
廼|in other words, thou, you, possessive particle
廠|workshop
廈|house
嶼|island
崗|hill
崑|place name
岱|old name for a Chinese mountain, Taishan
屹|towering mountains
屓|exerting strength (aikido)
寇|
學|
孵|hatch, incubate
娜|graceful
娑|old woman
姶|good-looking, quiet
奢|extravagance, luxury
奘|large, great
夘|rabbit (zodiac sign)
壜|bottle, vial, jar
埒|picket, limits, be settled
囿|game preserve, pasture, garden
囀|sing, chirp, warble, chatter
噪|be noisy
噤|shut up
喨|clear voice
啖|eat
哥|big brother
呵|scold, blow on, reprove
吽|bark, growl
卉|grass
匣|box
冲|offing, open sea, rise high into sky
册|no. of books, volume
儡|defeat
儘|as it is, because
僭|boastfully usurp
傅|tutor
傀|large
假|temporary, interim, assumed (name), informal
俥|jinricksha, (kokuji)
俟|wait, depend on
佇|stop, linger, appearance, figure, bearing
踝|
踵|
皺|
頤|
戈|
兔|
猴|
豬|
鈎|
鯆|
鮠|
鯊|
鯰|
鰌|
鮃|
